n,B,U,L,C,D,D-C
1000,76,359,5,5373,8747,3374
1000,22,380,6,6944,8361,1417
1000,22,358,5,7220,7608,388
1000,35,361,5,8476,9941,1465
1000,24,342,5,7484,10850,3366
1000,56,370,6,8648,9793,1145
1000,28,385,5,6468,9964,3496
1000,8,379,5,5710,12126,6416
1000,20,393,6,6521,8115,1594
1000,12,366,5,7667,11466,3799
1000,65,375,5,6455,7360,905
1000,26,354,5,5540,8814,3274
1000,32,367,6,7434,9086,1652
1000,21,356,5,6004,8692,2688
1000,38,378,6,7267,9072,1805
1000,70,354,6,8011,8470,459
1000,36,354,6,8961,9966,1005
1000,77,381,6,6545,8316,1771
1000,13,356,5,5074,9594,4520
1000,67,364,7,11724,12771,1047
1000,21,370,5,6441,9532,3091
1000,24,379,7,11538,12720,1182
1000,20,374,5,7495,9417,1922
1000,9,367,6,7037,8033,996
1000,52,361,5,6710,12485,5775
1000,26,371,5,6813,8466,1653
1000,55,362,6,7624,9128,1504
1000,23,368,5,6774,10557,3783
1000,63,366,5,6861,8326,1465
1000,35,401,6,6258,8986,2728
1000,38,375,5,9073,10992,1919
1000,71,384,6,6754,10878,4124
1000,44,365,6,6717,7540,823
1000,15,367,6,7892,9874,1982
1000,52,363,5,8976,11288,2312
1000,31,382,9,6619,9156,2537
1000,52,380,5,7058,9796,2738
1000,42,362,6,6553,8306,1753
1000,84,381,6,8578,9353,775
1000,30,351,4,8013,9097,1084
1000,36,357,5,8515,10188,1673
1000,17,386,5,8712,9786,1074
1000,40,369,5,8132,10087,1955
1000,38,371,5,12940,13545,605
1000,15,375,6,7197,8768,1571
1000,47,370,5,6157,8337,2180
1000,31,377,5,8259,12001,3742
1000,65,372,5,8151,9799,1648
1000,50,365,6,7070,9093,2023
1000,48,363,6,8672,11417,2745
2000,39,724,5,15784,20863,5079
2000,71,737,7,14860,20425,5565
2000,44,740,5,15051,19203,4152
2000,31,731,7,12709,18761,6052
2000,70,741,5,16357,20678,4321
2000,80,741,6,13633,17436,3803
2000,22,743,6,11628,19158,7530
2000,44,722,5,16226,18080,1854
2000,106,716,6,22801,23655,854
2000,44,732,6,15166,20114,4948
2000,92,731,5,18344,23902,5558
2000,51,749,6,18563,20331,1768
2000,14,736,6,16431,24884,8453
2000,50,726,6,19558,25244,5686
2000,38,742,6,14523,21879,7356
2000,90,718,7,16077,24380,8303
2000,57,759,7,15966,24324,8358
2000,53,742,5,18873,19596,723
2000,60,748,5,20207,22268,2061
2000,125,747,6,18153,23709,5556
2000,35,740,6,13794,28969,15175
2000,16,717,6,18049,19988,1939
2000,66,755,7,18559,24864,6305
2000,28,765,6,16727,22914,6187
2000,29,723,6,14521,26381,11860
2000,29,739,6,13795,23184,9389
2000,32,747,5,16587,19986,3399
2000,76,729,5,17476,18725,1249
2000,38,737,6,18763,19122,359
2000,27,752,6,25969,27779,1810
2000,66,733,5,14607,19237,4630
2000,31,752,5,13402,26387,12985
2000,3,749,6,14208,18521,4313
2000,65,711,5,13646,22173,8527
2000,90,766,6,15806,18598,2792
2000,55,727,6,15153,17888,2735
2000,105,735,6,17160,20861,3701
2000,51,712,5,16311,17209,898
2000,80,732,6,14449,20973,6524
2000,71,687,5,23035,25647,2612
2000,95,743,6,14095,18771,4676
2000,32,745,5,13490,22929,9439
2000,30,738,6,15957,22807,6850
2000,94,740,6,18984,20759,1775
2000,99,766,6,13425,21599,8174
2000,54,717,6,12530,19833,7303
2000,76,724,7,16659,20204,3545
2000,15,750,6,17345,19732,2387
2000,22,728,6,14585,18960,4375
2000,52,728,6,14669,18173,3504
3000,17,1115,5,27132,31385,4253
3000,77,1113,6,23734,30494,6760
3000,48,1097,7,26171,34717,8546
3000,68,1091,6,26514,30075,3561
3000,111,1117,5,23314,26375,3061
3000,12,1105,6,23058,39718,16660
3000,46,1061,6,32434,39253,6819
3000,65,1110,6,21628,30702,9074
3000,117,1105,7,26199,38608,12409
3000,60,1085,5,22873,24743,1870
3000,101,1067,6,21450,31235,9785
3000,88,1103,6,28204,36017,7813
3000,128,1100,6,40311,42184,1873
3000,40,1100,6,21642,34615,12973
3000,92,1106,6,21891,31697,9806
3000,72,1084,6,24565,30661,6096
3000,101,1100,6,32508,33912,1404
3000,154,1108,6,26459,29604,3145
3000,136,1098,7,27264,31357,4093
3000,88,1086,6,26812,35216,8404
3000,43,1119,6,34133,39280,5147
3000,91,1097,7,28004,31164,3160
3000,66,1079,6,24518,35269,10751
3000,98,1110,6,23653,28827,5174
3000,15,1069,6,22960,27886,4926
3000,41,1090,6,22167,33147,10980
3000,91,1122,6,24145,42453,18308
3000,46,1123,5,24325,27092,2767
3000,57,1123,7,22101,36986,14885
3000,46,1091,6,22102,30469,8367
3000,155,1111,6,22904,29929,7025
3000,29,1097,7,24550,27846,3296
3000,94,1090,7,32133,33370,1237
3000,79,1097,6,28787,33340,4553
3000,56,1099,6,35521,40959,5438
3000,139,1072,6,27594,36467,8873
3000,60,1116,5,25817,33440,7623
3000,42,1127,7,21044,29645,8601
3000,102,1080,6,30341,36871,6530
3000,88,1111,6,28418,30631,2213
3000,43,1113,7,25252,30400,5148
3000,32,1121,6,27303,32321,5018
3000,77,1128,6,22552,28932,6380
3000,29,1110,6,31116,36199,5083
3000,57,1122,6,32357,33457,1100
3000,75,1105,6,24527,29845,5318
3000,27,1098,6,31183,31292,109
3000,108,1122,6,27022,34145,7123
3000,30,1098,7,25491,33071,7580
3000,71,1115,5,25442,32512,7070
4000,64,1494,6,44253,48173,3920
4000,24,1495,6,37326,39952,2626
4000,56,1452,7,42499,46847,4348
4000,92,1466,6,30129,47148,17019
4000,76,1467,6,31925,44445,12520
4000,36,1510,6,31722,49535,17813
4000,25,1488,7,33595,48944,15349
4000,31,1477,6,39036,44571,5535
4000,58,1453,6,39024,47327,8303
4000,192,1503,6,36743,45373,8630
4000,82,1465,6,38234,51274,13040
4000,42,1443,6,27459,42043,14584
4000,72,1492,6,32263,38449,6186
4000,67,1473,7,31351,44027,12676
4000,44,1430,6,28643,43911,15268
4000,113,1436,6,31547,45885,14338
4000,95,1492,6,29568,36129,6561
4000,93,1471,6,37259,44333,7074
4000,106,1487,5,33698,42445,8747
4000,55,1454,6,31052,49957,18905
4000,29,1477,6,48859,55820,6961
4000,43,1465,6,32952,46738,13786
4000,87,1471,6,44429,48007,3578
4000,100,1491,6,38162,44446,6284
4000,13,1518,6,38502,45561,7059
4000,140,1496,7,34686,46838,12152
4000,48,1481,6,30104,39103,8999
4000,72,1458,6,46979,56579,9600
4000,62,1467,6,35572,49979,14407
4000,135,1454,6,64755,65142,387
4000,79,1442,6,37127,37572,445
4000,74,1498,6,32757,37497,4740
4000,170,1474,5,36654,41488,4834
4000,41,1475,6,36269,45857,9588
4000,62,1461,6,39445,43448,4003
4000,73,1474,5,29247,39052,9805
4000,94,1502,5,36461,40175,3714
4000,105,1491,6,34104,43672,9568
4000,106,1468,6,31445,51506,20061
4000,80,1504,6,33136,44566,11430
4000,90,1466,6,31357,44523,13166
4000,49,1469,6,46562,56719,10157
4000,96,1492,6,30947,40410,9463
4000,50,1470,6,35733,45017,9284
4000,72,1506,7,28253,43650,15397
4000,33,1492,6,29360,45179,15819
4000,110,1484,6,31994,44627,12633
4000,29,1496,5,35262,44671,9409
4000,65,1470,6,52791,58417,5626
4000,67,1505,7,30506,39746,9240
5000,76,1805,6,50800,57216,6416
5000,156,1850,6,69985,71726,1741
5000,71,1847,7,41264,48157,6893
5000,139,1818,6,42870,53806,10936
5000,160,1813,7,42851,66645,23794
5000,92,1873,7,45867,52862,6995
5000,118,1859,7,41492,51023,9531
5000,54,1825,6,45797,56778,10981
5000,84,1822,6,54685,61094,6409
5000,41,1849,6,44775,62735,17960
5000,23,1827,7,39004,59782,20778
5000,64,1862,6,45367,57338,11971
5000,97,1829,6,42575,50856,8281
5000,61,1842,6,39388,47311,7923
5000,135,1843,6,39444,53061,13617
5000,60,1830,7,48359,61605,13246
5000,158,1807,6,59844,83576,23732
5000,60,1813,6,42891,59596,16705
5000,24,1846,6,51691,54083,2392
5000,52,1826,6,46085,52983,6898
5000,135,1857,6,44380,49421,5041
5000,97,1849,8,48384,60553,12169
5000,190,1865,6,39925,54539,14614
5000,125,1831,7,38824,55709,16885
5000,144,1838,7,45685,62424,16739
5000,91,1818,7,40622,53084,12462
5000,76,1852,6,42594,57112,14518
5000,164,1847,7,35842,53324,17482
5000,122,1831,7,41233,52240,11007
5000,120,1838,7,47940,63524,15584
5000,68,1855,6,45540,59078,13538
5000,32,1830,7,38425,54351,15926
5000,122,1828,6,42260,58536,16276
5000,8,1867,7,41128,54120,12992
5000,155,1804,7,48996,55337,6341
5000,106,1873,6,54983,61279,6296
5000,34,1829,6,38546,46882,8336
5000,69,1829,6,47090,54869,7779
5000,57,1833,6,41302,52282,10980
5000,54,1829,6,58105,58875,770
5000,163,1819,7,39541,54357,14816
5000,134,1808,6,38843,57268,18425
5000,103,1829,7,37362,53584,16222
5000,97,1871,7,43259,54537,11278
5000,114,1868,7,46020,57434,11414
5000,101,1806,7,56442,62624,6182
5000,70,1825,7,35616,53939,18323
5000,48,1817,6,38137,60619,22482
5000,249,1870,6,38311,45982,7671
5000,84,1807,7,40737,58297,17560
6000,227,2211,6,56187,64328,8141
6000,105,2220,6,54786,64826,10040
6000,147,2187,6,46145,65496,19351
6000,87,2177,7,65526,69668,4142
6000,123,2193,6,50282,67780,17498
6000,110,2243,6,54985,76924,21939
6000,106,2215,6,60504,67736,7232
6000,48,2207,6,54814,59423,4609
6000,99,2201,6,50453,79797,29344
6000,83,2212,8,54044,66882,12838
6000,114,2215,6,44569,56877,12308
6000,63,2242,6,51630,71959,20329
6000,102,2216,6,53686,61467,7781
6000,14,2220,7,69549,69838,289
6000,20,2162,7,64936,71983,7047
6000,155,2153,6,61312,87048,25736
6000,54,2203,7,61929,72136,10207
6000,43,2238,6,61406,66693,5287
6000,103,2249,7,52287,71565,19278
6000,59,2162,6,56365,67896,11531
6000,176,2193,6,72388,75710,3322
6000,73,2188,6,48982,70638,21656
6000,178,2216,6,47994,69686,21692
6000,116,2176,6,62252,66487,4235
6000,60,2185,7,60787,68440,7653
6000,225,2185,5,49523,66506,16983
6000,91,2247,6,54943,71198,16255
6000,85,2163,7,56514,57977,1463
6000,177,2219,6,53443,67441,13998
6000,144,2246,6,64636,75195,10559
6000,16,2209,6,57612,72221,14609
6000,138,2275,7,61861,71130,9269
6000,36,2193,6,65591,69836,4245
6000,145,2202,8,55529,68389,12860
6000,244,2197,7,53526,71700,18174
6000,23,2199,7,62457,67712,5255
6000,115,2201,6,49964,75337,25373
6000,115,2212,6,75948,94424,18476
6000,103,2191,7,58902,65142,6240
6000,102,2190,5,48532,66537,18005
6000,62,2240,8,73212,74657,1445
6000,190,2187,6,54137,73886,19749
6000,100,2174,7,52938,80935,27997
6000,95,2232,6,49228,70227,20999
6000,180,2244,6,56780,64365,7585
6000,130,2214,5,44560,62456,17896
6000,137,2205,7,50141,64865,14724
6000,25,2226,6,62815,69337,6522
6000,131,2202,8,63002,76009,13007
6000,111,2201,7,56421,74902,18481
7000,78,2578,6,90300,97652,7352
7000,69,2549,6,83626,84181,555
7000,116,2548,8,58381,72909,14528
7000,145,2567,5,75233,78236,3003
7000,63,2574,7,58156,87274,29118
7000,105,2554,6,56014,72967,16953
7000,132,2570,6,56339,91775,35436
7000,53,2542,6,68649,83824,15175
7000,129,2534,6,85817,85965,148
7000,156,2532,7,53192,77672,24480
7000,46,2584,7,59148,86039,26891
7000,81,2589,6,80475,97260,16785
7000,149,2559,7,54592,82415,27823
7000,205,2562,6,55595,75343,19748
7000,130,2572,6,77253,113073,35820
7000,92,2602,6,72564,81252,8688
7000,177,2574,7,61742,83741,21999
7000,141,2595,8,60356,69903,9547
7000,35,2581,7,63678,88958,25280
7000,147,2555,6,72344,90800,18456
7000,180,2559,6,75825,90772,14947
7000,89,2599,6,60921,74712,13791
7000,23,2592,8,78761,91404,12643
7000,153,2585,6,55721,81885,26164
7000,153,2591,6,61194,100278,39084
7000,121,2590,6,57394,82090,24696
7000,121,2593,6,69716,75459,5743
7000,137,2581,6,54010,89153,35143
7000,104,2576,6,73904,79025,5121
7000,41,2567,7,50133,74874,24741
7000,32,2566,7,66453,81941,15488
7000,43,2557,7,69612,86968,17356
7000,36,2595,6,53112,87414,34302
7000,24,2610,6,59698,93099,33401
7000,114,2579,8,54368,101264,46896
7000,56,2592,6,67148,86593,19445
7000,84,2575,7,56745,85583,28838
7000,104,2586,6,66056,76494,10438
7000,126,2649,7,58207,91294,33087
7000,26,2542,5,68589,88418,19829
7000,89,2594,7,56745,83453,26708
7000,93,2566,6,65895,79876,13981
7000,274,2549,6,66653,81109,14456
7000,124,2579,6,63112,76812,13700
7000,200,2565,7,65765,91345,25580
7000,92,2570,6,70277,87685,17408
7000,41,2608,7,71226,115448,44222
7000,159,2569,6,67226,107109,39883
7000,101,2594,6,69490,92377,22887
7000,217,2542,6,51747,78450,26703
8000,104,2947,7,78970,97014,18044
8000,15,2967,6,62982,88790,25808
8000,57,2910,6,66437,87721,21284
8000,157,2939,6,77724,93419,15695
8000,127,3009,7,79294,88429,9135
8000,71,2961,6,73677,92017,18340
8000,97,2968,5,92972,95361,2389
8000,68,2969,7,70815,90241,19426
8000,62,2916,7,71446,91229,19783
8000,205,2933,6,72089,90102,18013
8000,72,2922,7,78527,89142,10615
8000,151,2865,7,78101,99403,21302
8000,144,2928,6,66363,96124,29761
8000,222,2943,7,97221,110871,13650
8000,81,2959,6,65189,93845,28656
8000,214,2912,7,75764,95131,19367
8000,58,2961,6,75573,105017,29444
8000,80,2976,7,80054,82317,2263
8000,72,2899,6,78054,93164,15110
8000,155,2942,7,79130,103487,24357
8000,210,2900,7,66638,90051,23413
8000,137,2969,7,79083,97319,18236
8000,51,2908,6,100883,108841,7958
8000,133,2993,7,74239,100533,26294
8000,143,2927,6,74877,86771,11894
8000,94,2922,7,78190,100627,22437
8000,67,2953,6,80525,129761,49236
8000,148,2951,6,79624,107285,27661
8000,47,2934,7,65141,85159,20018
8000,214,2911,6,84519,89154,4635
8000,115,2910,7,85438,97757,12319
8000,129,2904,6,70781,79094,8313
8000,216,2953,7,88229,108084,19855
8000,102,2953,7,63860,92198,28338
8000,170,2901,6,61896,77633,15737
8000,86,2950,7,68941,85743,16802
8000,98,2949,6,78122,98655,20533
8000,147,3001,6,67619,89043,21424
8000,114,2936,7,73688,107322,33634
8000,143,2954,6,78555,91833,13278
8000,28,2935,6,72744,110906,38162
8000,172,2906,7,68878,80792,11914
8000,51,2956,8,81483,86152,4669
8000,83,2921,7,92027,93328,1301
8000,134,2944,6,95201,101288,6087
8000,30,2991,7,84181,95711,11530
8000,90,2909,7,69933,90501,20568
8000,254,2902,6,64392,88904,24512
8000,111,2958,7,68925,108047,39122
8000,81,2918,6,78853,85176,6323
9000,98,3278,6,76711,127001,50290
9000,257,3321,7,86834,96291,9457
9000,51,3271,7,81890,113198,31308
9000,191,3335,6,100786,102880,2094
9000,37,3358,6,82654,111770,29116
9000,116,3315,6,72452,85966,13514
9000,141,3377,6,91851,98870,7019
9000,152,3254,6,76803,94759,17956
9000,202,3341,6,75204,96319,21115
9000,246,3342,6,93947,103693,9746
9000,148,3364,7,93550,108254,14704
9000,149,3359,9,79123,112234,33111
9000,118,3347,6,78578,98129,19551
9000,166,3324,7,93370,111681,18311
9000,86,3307,6,91744,116784,25040
9000,31,3297,7,91016,119675,28659
9000,12,3356,8,86682,108202,21520
9000,66,3301,7,87709,105557,17848
9000,92,3273,6,89354,95125,5771
9000,9,3321,7,93618,107875,14257
9000,112,3344,7,80759,101138,20379
9000,213,3361,7,78493,98472,19979
9000,81,3345,6,83616,92153,8537
9000,180,3338,8,108781,111970,3189
9000,133,3284,6,72215,105313,33098
9000,50,3271,6,79494,120181,40687
9000,83,3309,7,79155,95990,16835
9000,104,3350,6,88010,114094,26084
9000,142,3356,6,85014,118930,33916
9000,166,3297,7,73162,88582,15420
9000,176,3307,6,80943,109349,28406
9000,90,3285,7,92150,106072,13922
9000,149,3322,7,79130,96195,17065
9000,118,3304,6,80964,154614,73650
9000,174,3336,7,80144,96281,16137
9000,58,3323,8,85929,107960,22031
9000,37,3339,6,88455,93404,4949
9000,81,3326,6,79611,106447,26836
9000,60,3296,6,85120,96675,11555
9000,97,3326,6,99857,115344,15487
9000,107,3338,6,77456,96019,18563
9000,124,3323,7,83081,102549,19468
9000,82,3289,8,80786,98709,17923
9000,57,3333,7,79640,110507,30867
9000,262,3320,7,96216,97364,1148
9000,42,3352,7,88831,113777,24946
9000,49,3338,7,74321,85183,10862
9000,128,3357,7,84526,124700,40174
9000,186,3257,7,88962,92410,3448
9000,178,3344,6,77275,106039,28764
10000,39,3688,7,113498,136573,23075
10000,40,3674,6,92582,135739,43157
10000,92,3696,7,90266,128772,38506
10000,68,3695,6,94733,126807,32074
10000,171,3715,7,83031,124260,41229
10000,110,3677,6,93337,115197,21860
10000,58,3682,6,84512,126374,41862
10000,306,3617,6,88434,123102,34668
10000,67,3687,6,112743,121645,8902
10000,134,3683,6,94229,135212,40983
10000,117,3664,6,95264,127928,32664
10000,137,3662,7,97950,133558,35608
10000,102,3684,7,104987,115375,10388
10000,80,3673,7,106173,135215,29042
10000,272,3661,6,85675,116059,30384
10000,209,3664,6,102614,136883,34269
10000,204,3700,6,89494,104135,14641
10000,92,3711,6,92260,114317,22057
10000,14,3666,6,95632,114835,19203
10000,128,3652,7,81911,105993,24082
10000,151,3620,6,84692,130083,45391
10000,161,3646,7,103970,131684,27714
10000,61,3676,7,104140,119901,15761
10000,78,3697,7,83373,118719,35346
10000,92,3665,7,97615,140052,42437
10000,173,3675,6,95618,109115,13497
10000,96,3715,6,115912,121628,5716
10000,41,3753,7,130589,147449,16860
10000,130,3678,7,91919,123177,31258
10000,89,3658,7,94359,130071,35712
10000,159,3731,7,107899,122348,14449
10000,61,3727,6,91104,126380,35276
10000,120,3736,7,96140,119292,23152
10000,47,3711,6,99125,112069,12944
10000,113,3745,8,124493,137624,13131
10000,155,3652,6,127206,129593,2387
10000,100,3755,6,110858,126691,15833
10000,226,3664,7,90400,111184,20784
10000,159,3659,5,87890,122747,34857
10000,129,3684,7,117987,134866,16879
10000,152,3727,7,97576,111563,13987
10000,61,3659,7,89122,121674,32552
10000,171,3672,7,83930,117666,33736
10000,89,3695,6,108745,115249,6504
10000,156,3731,6,95006,120457,25451
10000,82,3604,7,92960,116708,23748
10000,178,3697,7,93947,110988,17041
10000,195,3657,9,101195,124166,22971
10000,38,3623,6,118451,124673,6222
10000,82,3714,7,108010,119198,11188
11000,171,4030,7,107823,130491,22668
11000,173,4022,6,106864,168368,61504
11000,91,3951,7,91641,120981,29340
11000,65,4136,7,110021,144298,34277
11000,130,4006,6,106466,140459,33993
11000,127,4036,6,105244,129123,23879
11000,182,4070,6,102837,133727,30890
11000,175,4128,7,93570,129741,36171
11000,145,4033,7,104476,132891,28415
11000,171,4092,6,103225,117605,14380
11000,68,4030,6,94756,136425,41669
11000,251,4040,7,92794,140457,47663
11000,56,3990,7,91435,132477,41042
11000,208,4053,6,99247,158428,59181
11000,8,4043,8,91795,146114,54319
11000,86,4099,8,118711,123280,4569
11000,273,4075,7,107365,126096,18731
11000,163,4078,6,111457,132117,20660
11000,204,4060,7,126747,141358,14611
11000,134,4064,6,155962,163087,7125
11000,153,4045,6,110733,123289,12556
11000,40,4058,7,107641,139590,31949
11000,130,4027,7,87089,132568,45479
11000,85,4094,7,97213,151410,54197
11000,65,4051,7,102624,164779,62155
11000,66,4084,6,135696,156247,20551
11000,210,4060,9,102284,122732,20448
11000,330,4025,7,119231,125423,6192
11000,136,4005,7,121934,145654,23720
11000,163,4041,6,107967,134424,26457
11000,108,4101,8,109673,135937,26264
11000,150,4069,6,93963,160153,66190
11000,274,4049,6,99528,116741,17213
11000,58,4052,7,94442,111536,17094
11000,157,4075,7,108804,156070,47266
11000,204,4054,7,118867,161545,42678
11000,149,4044,6,96035,128306,32271
11000,148,4096,7,97479,134211,36732
11000,39,4064,6,114279,117788,3509
11000,23,4037,9,113911,162165,48254
11000,85,4032,8,93122,132490,39368
11000,86,4065,7,94253,139589,45336
11000,104,4056,6,103089,143381,40292
11000,133,4050,7,124558,136814,12256
11000,137,4066,7,197443,207585,10142
11000,151,3997,6,97914,130347,32433
11000,355,4046,7,142355,169338,26983
11000,39,3949,7,121947,142764,20817
11000,131,4052,6,105057,133783,28726
11000,65,3985,7,116450,134031,17581
12000,115,4421,6,105366,147719,42353
12000,18,4400,7,116652,142525,25873
12000,90,4392,7,98947,160948,62001
12000,57,4423,7,161046,174856,13810
12000,297,4448,8,146447,164687,18240
12000,62,4389,6,130896,153872,22976
12000,93,4376,7,130339,160269,29930
12000,174,4406,6,117129,146171,29042
12000,70,4418,7,123615,139951,16336
12000,29,4453,6,113610,165612,52002
12000,77,4360,6,132516,151713,19197
12000,157,4425,6,149021,183423,34402
12000,27,4474,7,111490,163935,52445
12000,28,4442,7,117813,123235,5422
12000,86,4375,7,118056,156136,38080
12000,215,4388,7,101432,162387,60955
12000,100,4393,6,102029,140821,38792
12000,224,4390,7,131637,140900,9263
12000,102,4431,6,106661,152750,46089
12000,140,4445,8,105465,147647,42182
12000,144,4440,6,112415,137739,25324
12000,59,4497,8,109845,138351,28506
12000,147,4427,6,106090,144439,38349
12000,94,4363,7,98780,161222,62442
12000,258,4403,7,119679,149156,29477
12000,79,4379,6,117821,171676,53855
12000,93,4370,7,116738,148614,31876
12000,22,4404,6,116806,140553,23747
12000,57,4435,6,140331,153010,12679
12000,122,4391,6,131102,176963,45861
12000,258,4378,7,105285,169676,64391
12000,317,4390,7,108336,137420,29084
12000,154,4416,7,105244,153769,48525
12000,251,4431,7,114516,152659,38143
12000,168,4368,6,117384,123892,6508
12000,172,4353,6,112338,130559,18221
12000,262,4426,7,115268,142212,26944
12000,217,4401,8,120507,149994,29487
12000,246,4390,6,112480,162399,49919
12000,59,4415,7,134404,150955,16551
12000,292,4410,7,144059,159301,15242
12000,93,4386,6,117508,146980,29472
12000,61,4470,8,117793,129517,11724
12000,130,4399,6,110402,156680,46278
12000,41,4443,7,102255,147754,45499
12000,149,4327,6,109745,129978,20233
12000,143,4408,8,119187,162567,43380
12000,52,4351,6,103607,130607,27000
12000,175,4355,7,143972,145912,1940
12000,122,4454,8,131382,136828,5446
13000,63,4802,6,168688,204207,35519
13000,107,4765,6,122882,172523,49641
13000,214,4747,7,191040,201340,10300
13000,125,4863,6,135173,155282,20109
13000,229,4800,8,176817,189443,12626
13000,65,4839,8,114105,178363,64258
13000,129,4758,7,129523,149102,19579
13000,185,4785,7,106972,173872,66900
13000,59,4836,7,137690,171378,33688
13000,131,4743,6,139987,164380,24393
13000,230,4745,7,127052,148675,21623
13000,104,4805,7,166743,170232,3489
13000,79,4743,6,153403,206590,53187
13000,239,4825,8,119295,135693,16398
13000,333,4825,7,118111,203899,85788
13000,105,4851,7,134813,153145,18332
13000,132,4781,7,174995,178706,3711
13000,101,4725,7,140221,188600,48379
13000,138,4821,8,130308,147523,17215
13000,127,4833,6,102258,153620,51362
13000,169,4737,8,135230,148257,13027
13000,48,4805,7,139937,159666,19729
13000,201,4781,7,127931,159004,31073
13000,138,4788,7,125741,153928,28187
13000,59,4796,6,122297,164167,41870
13000,163,4800,6,110404,164972,54568
13000,38,4732,6,129837,147724,17887
13000,94,4782,7,127432,159965,32533
13000,90,4803,8,134280,152610,18330
13000,228,4838,6,123958,177137,53179
13000,15,4804,7,145712,172204,26492
13000,131,4685,6,129265,157819,28554
13000,80,4790,7,136387,168027,31640
13000,61,4737,6,135177,153514,18337
13000,114,4801,7,119881,185681,65800
13000,86,4722,6,118028,159062,41034
13000,161,4716,6,140873,166876,26003
13000,127,4810,6,115817,150237,34420
13000,377,4832,7,120407,158518,38111
13000,160,4815,7,111243,146775,35532
13000,230,4745,8,122585,159185,36600
13000,59,4830,9,143907,155426,11519
13000,282,4784,7,130103,159454,29351
13000,202,4749,7,121234,156082,34848
13000,130,4720,6,113413,151966,38553
13000,106,4802,6,128253,163946,35693
13000,86,4762,7,150206,152303,2097
13000,65,4821,7,123300,166791,43491
13000,128,4797,6,115044,167380,52336
13000,248,4783,7,117222,150489,33267
14000,273,5103,8,154807,173174,18367
14000,278,5158,6,135170,179592,44422
14000,293,5153,7,162721,184670,21949
14000,97,5089,6,148433,153113,4680
14000,98,5126,6,118983,190135,71152
14000,248,5116,6,139958,158360,18402
14000,181,5155,7,134665,180135,45470
14000,119,5139,6,129796,163329,33533
14000,124,5179,7,169760,180635,10875
14000,75,5134,7,155710,170210,14500
14000,153,5122,7,131038,182727,51689
14000,59,5187,7,130270,186398,56128
14000,199,5200,8,117797,164845,47048
14000,256,5099,8,155290,173012,17722
14000,94,5097,6,143475,170314,26839
14000,232,5163,6,136631,173519,36888
14000,254,5143,7,136978,174258,37280
14000,22,5160,7,128822,200964,72142
14000,111,5136,7,144852,161843,16991
14000,162,5124,8,123423,166696,43273
14000,212,5199,6,127780,201389,73609
14000,143,5181,6,155274,202243,46969
14000,122,5190,6,147672,160860,13188
14000,95,5109,6,173926,177758,3832
14000,148,5098,6,127152,158193,31041
14000,69,5192,6,152452,176549,24097
14000,74,5176,9,148592,170366,21774
14000,75,5135,7,154874,176685,21811
14000,104,5087,6,145415,168945,23530
14000,176,5137,7,123233,175914,52681
14000,133,5126,6,141904,180852,38948
14000,103,5190,7,126011,177696,51685
14000,207,5163,7,114806,224607,109801
14000,245,5138,8,133211,168151,34940
14000,116,5169,6,152217,162252,10035
14000,46,5213,7,159211,168531,9320
14000,44,5216,7,150102,164096,13994
14000,118,5150,8,126124,163348,37224
14000,336,5113,7,187979,207490,19511
14000,61,5117,6,151051,204800,53749
14000,85,5112,7,130262,152870,22608
14000,89,5158,8,153652,176620,22968
14000,217,5153,7,130968,189325,58357
14000,88,5116,7,137295,195942,58647
14000,185,5168,6,135947,196330,60383
14000,264,5102,6,117025,142342,25317
14000,259,5178,6,159918,224278,64360
14000,173,5138,7,157438,188006,30568
14000,222,5161,8,157401,194546,37145
14000,189,5096,6,120451,191481,71030
15000,225,5598,9,129338,185530,56192
15000,10,5484,8,195723,242361,46638
15000,199,5545,8,137555,192512,54957
15000,234,5578,6,161831,193141,31310
15000,313,5477,7,156140,166526,10386
15000,205,5519,6,161752,180777,19025
15000,13,5560,7,129407,183444,54037
15000,281,5548,8,155861,180821,24960
15000,204,5517,6,183531,191993,8462
15000,30,5527,6,148095,214212,66117
15000,183,5504,7,143004,174976,31972
15000,133,5469,6,146547,188333,41786
15000,65,5527,7,136495,196323,59828
15000,146,5542,7,167809,179660,11851
15000,177,5524,7,149560,177927,28367
15000,110,5473,7,148763,186883,38120
15000,77,5549,6,133504,183180,49676
15000,72,5547,7,160398,180001,19603
15000,142,5535,8,140292,183141,42849
15000,148,5459,7,127709,211341,83632
15000,181,5489,7,199569,206918,7349
15000,71,5519,6,131517,161808,30291
15000,62,5482,6,152249,175594,23345
15000,92,5588,6,154772,219989,65217
15000,294,5533,7,122434,170907,48473
15000,239,5502,8,150784,183874,33090
15000,21,5462,7,160463,182796,22333
15000,226,5450,7,150310,179298,28988
15000,217,5526,6,179576,192763,13187
15000,189,5498,7,168551,243223,74672
15000,116,5483,7,144591,195796,51205
15000,247,5595,7,153351,181324,27973
15000,70,5514,7,156868,184489,27621
15000,79,5525,6,141379,185891,44512
15000,117,5587,6,145397,169693,24296
15000,136,5492,6,162882,191615,28733
15000,63,5498,8,144460,161457,16997
15000,332,5534,7,147009,216964,69955
15000,117,5486,6,151659,217332,65673
15000,94,5550,7,141344,182375,41031
15000,123,5546,6,146463,216627,70164
15000,70,5572,6,155085,200563,45478
15000,155,5530,7,127459,182794,55335
15000,199,5514,7,148174,160999,12825
15000,92,5551,6,160364,182948,22584
15000,270,5448,7,159317,164349,5032
15000,253,5442,7,148007,198511,50504
15000,213,5525,6,146020,227323,81303
15000,159,5501,7,149579,173022,23443
15000,107,5455,7,157751,202683,44932
16000,257,5926,8,145078,171535,26457
16000,159,5895,7,156633,173119,16486
16000,154,5854,6,145511,222952,77441
16000,56,5824,7,159066,174579,15513
16000,130,5881,6,192447,208537,16090
16000,191,5908,7,141309,195296,53987
16000,253,5795,6,158811,180027,21216
16000,104,5944,6,159295,216162,56867
16000,243,5783,8,155808,229691,73883
16000,337,5876,6,146444,169422,22978
16000,217,5884,7,183255,183355,100
16000,264,5877,9,147980,174408,26428
16000,112,5881,7,162960,189246,26286
16000,277,5904,8,160572,200828,40256
16000,93,5950,7,161420,210431,49011
16000,375,5931,7,182056,240385,58329
16000,99,5902,8,179673,196825,17152
16000,145,5835,8,134765,176919,42154
16000,141,5876,7,169680,188532,18852
16000,130,5836,7,184647,263182,78535
16000,210,5865,6,173121,229812,56691
16000,52,5852,7,161199,188840,27641
16000,68,5913,7,140258,201258,61000
16000,173,5961,7,149684,210541,60857
16000,208,5835,7,152125,229316,77191
16000,171,5946,6,153395,194807,41412
16000,110,5885,7,177750,248200,70450
16000,56,5870,7,189259,250712,61453
16000,93,5876,6,140780,178587,37807
16000,84,5856,7,153666,194439,40773
16000,107,5930,7,180362,194008,13646
16000,157,5910,7,160308,198457,38149
16000,145,5865,6,170101,174480,4379
16000,156,5818,6,146706,214811,68105
16000,148,5903,6,162545,227363,64818
16000,74,5861,7,165221,181399,16178
16000,182,5926,7,172217,194573,22356
16000,246,5908,7,181387,188594,7207
16000,86,5879,8,149253,207973,58720
16000,176,5858,7,164218,189829,25611
16000,67,5839,7,168226,218867,50641
16000,234,5943,7,163281,173629,10348
16000,40,5955,7,149766,203577,53811
16000,81,5921,7,166221,194740,28519
16000,203,5809,7,146197,221658,75461
16000,119,5903,7,143807,203962,60155
16000,170,5815,7,173428,188245,14817
16000,53,5894,6,198726,208873,10147
16000,66,5915,8,175270,226473,51203
16000,207,5897,6,149638,188785,39147
17000,50,6157,8,193141,208789,15648
17000,125,6225,7,162858,239447,76589
17000,93,6233,7,193572,200440,6868
17000,125,6188,6,174752,197307,22555
17000,305,6285,8,169673,202037,32364
17000,101,6235,7,164224,234071,69847
17000,85,6214,8,213961,222333,8372
17000,230,6242,8,174095,210673,36578
17000,215,6286,6,160049,223461,63412
17000,125,6309,7,187122,189808,2686
17000,97,6276,7,181441,266635,85194
17000,156,6257,7,180671,219748,39077
17000,210,6279,7,169961,204310,34349
17000,68,6185,6,189234,209537,20303
17000,139,6225,7,181593,203787,22194
17000,95,6240,6,181881,201671,19790
17000,92,6246,6,168194,208529,40335
17000,158,6211,7,167658,225957,58299
17000,91,6199,6,161287,201007,39720
17000,133,6316,7,181333,224576,43243
17000,141,6227,6,155608,233946,78338
17000,137,6223,6,193009,204311,11302
17000,260,6350,7,163221,204125,40904
17000,241,6240,8,160619,192738,32119
17000,55,6233,7,186306,214474,28168
17000,57,6261,6,174087,229208,55121
17000,40,6328,7,230922,276390,45468
17000,35,6255,7,187687,259039,71352
17000,130,6238,8,199954,221801,21847
17000,231,6251,7,177659,204033,26374
17000,28,6278,6,171820,197827,26007
17000,153,6307,8,195870,218117,22247
17000,171,6239,6,166951,187777,20826
17000,89,6212,6,206608,218298,11690
17000,323,6250,7,209873,211882,2009
17000,112,6230,9,164083,218535,54452
17000,87,6243,8,168173,201013,32840
17000,214,6281,7,172431,237499,65068
17000,278,6255,7,225685,261917,36232
17000,86,6273,6,181097,203097,22000
17000,309,6225,6,189749,253582,63833
17000,139,6270,7,165072,229277,64205
17000,44,6261,8,178399,206850,28451
17000,243,6271,6,150569,205982,55413
17000,436,6276,8,169386,202890,33504
17000,57,6193,7,156225,202828,46603
17000,309,6380,7,150076,201265,51189
17000,50,6255,7,198190,222092,23902
17000,137,6311,6,156283,176330,20047
17000,477,6276,8,176771,236201,59430
18000,190,6681,7,274005,281772,7767
18000,73,6561,6,229812,249727,19915
18000,66,6638,7,197572,219604,22032
18000,332,6609,7,156199,210939,54740
18000,135,6574,7,171984,224133,52149
18000,85,6606,7,192067,208267,16200
18000,51,6620,7,224375,236302,11927
18000,170,6638,6,224246,290876,66630
18000,155,6693,6,162767,255921,93154
18000,51,6602,8,188794,210413,21619
18000,116,6671,7,161139,214185,53046
18000,336,6669,7,212388,248667,36279
18000,183,6585,8,181185,201832,20647
18000,146,6555,6,186870,227154,40284
18000,250,6707,7,166622,194217,27595
18000,262,6659,7,237186,247938,10752
18000,80,6616,7,156511,258252,101741
18000,182,6604,6,155891,218551,62660
18000,65,6665,7,216864,245271,28407
18000,133,6588,7,201066,258754,57688
18000,232,6635,6,182616,244519,61903
18000,97,6638,6,171908,200175,28267
18000,273,6627,7,186521,228491,41970
18000,208,6627,7,174371,262305,87934
18000,288,6584,7,160292,244029,83737
18000,71,6608,7,162091,255481,93390
18000,318,6633,6,191571,230015,38444
18000,273,6731,7,178174,245080,66906
18000,63,6573,8,184506,205688,21182
18000,202,6630,7,268906,291096,22190
18000,186,6645,7,180214,241793,61579
18000,208,6551,6,222887,226613,3726
18000,141,6586,7,171640,203961,32321
18000,138,6565,7,233071,241319,8248
18000,178,6635,7,180196,243889,63693
18000,231,6601,6,199314,212505,13191
18000,116,6578,7,161494,210296,48802
18000,142,6551,7,215012,236258,21246
18000,37,6599,6,212048,244126,32078
18000,124,6580,7,208597,275505,66908
18000,155,6671,7,174619,253767,79148
18000,321,6601,7,150824,228012,77188
18000,195,6610,7,205971,270175,64204
18000,392,6623,8,162063,201091,39028
18000,72,6650,8,189200,223542,34342
18000,139,6615,7,179670,230901,51231
18000,169,6640,6,158834,252198,93364
18000,123,6663,9,168110,203331,35221
18000,180,6588,7,190390,218897,28507
18000,179,6562,6,167412,240675,73263
19000,362,6969,7,223463,253556,30093
19000,82,7032,7,186568,240849,54281
19000,170,6911,7,182193,235821,53628
19000,165,7011,7,182949,255290,72341
19000,232,6964,7,217408,270595,53187
19000,267,6963,6,182641,230334,47693
19000,431,7040,7,224904,234208,9304
19000,262,7065,8,225271,229031,3760
19000,192,6950,7,194001,278599,84598
19000,53,6935,7,175020,328887,153867
19000,412,6988,8,189258,259864,70606
19000,109,6971,7,212140,252059,39919
19000,214,7031,7,169777,260174,90397
19000,307,7062,7,176644,254799,78155
19000,234,6897,6,287987,325226,37239
19000,326,7003,7,193106,243577,50471
19000,357,7049,6,179450,275558,96108
19000,339,6952,7,203063,286519,83456
19000,199,7001,7,203705,238696,34991
19000,233,6940,7,226885,236388,9503
19000,55,6941,8,201881,233049,31168
19000,125,7009,7,241168,302232,61064
19000,161,6948,8,191365,342968,151603
19000,292,6959,7,204769,208272,3503
19000,95,6958,7,166946,232031,65085
19000,25,6923,8,166769,258966,92197
19000,244,6986,6,219995,242355,22360
19000,59,6938,10,193866,252817,58951
19000,73,6947,7,247727,253368,5641
19000,398,6989,7,201662,227416,25754
19000,226,6977,7,156751,209108,52357
19000,33,6981,7,192710,271237,78527
19000,151,7075,8,225107,230958,5851
19000,91,6971,7,198083,246144,48061
19000,206,6962,7,184551,215973,31422
19000,43,7019,7,172408,249863,77455
19000,126,7036,8,182502,222297,39795
19000,123,6977,7,184388,255416,71028
19000,453,6966,8,181639,221121,39482
19000,296,7013,8,171936,229689,57753
19000,59,6960,7,221523,271540,50017
19000,37,7064,6,184685,250787,66102
19000,123,7060,7,189736,247113,57377
19000,264,7008,7,173971,288456,114485
19000,171,6904,7,186959,216499,29540
19000,287,6971,8,190150,215713,25563
19000,263,6989,7,195477,234532,39055
19000,311,6946,7,190980,239198,48218
19000,114,6951,7,200275,218667,18392
19000,206,6927,7,197981,250660,52679
20000,33,7318,7,175731,259420,83689
20000,347,7369,7,206442,263990,57548
20000,201,7422,10,209905,265439,55534
20000,123,7434,7,229971,303476,73505
20000,29,7352,7,199968,221591,21623
20000,326,7347,6,173187,252116,78929
20000,194,7365,7,214617,258349,43732
20000,321,7360,7,174426,285459,111033
20000,237,7392,6,180354,223557,43203
20000,138,7309,7,204330,232687,28357
20000,62,7371,8,201440,266840,65400
20000,117,7364,7,194430,250562,56132
20000,212,7291,7,232878,277543,44665
20000,254,7389,8,227578,285592,58014
20000,65,7426,7,206030,255191,49161
20000,170,7332,7,253359,256549,3190
20000,246,7350,7,212003,292875,80872
20000,321,7347,7,192702,252500,59798
20000,144,7363,8,199327,245955,46628
20000,81,7414,7,180543,253820,73277
20000,197,7354,7,205919,275425,69506
20000,94,7323,7,178286,239570,61284
20000,169,7423,6,199993,232720,32727
20000,313,7380,7,184334,277203,92869
20000,277,7324,7,190761,249601,58840
20000,114,7451,8,182333,230986,48653
20000,175,7329,8,186353,279695,93342
20000,142,7285,7,283658,331198,47540
20000,210,7387,6,199023,268143,69120
20000,130,7367,6,311686,321185,9499
20000,176,7373,7,184019,250386,66367
20000,101,7442,6,188526,245399,56873
20000,374,7408,6,193579,255474,61895
20000,174,7343,6,178602,243929,65327
20000,172,7427,7,295978,322874,26896
20000,130,7400,7,184036,241817,57781
20000,42,7394,7,192092,230977,38885
20000,311,7369,7,193479,291963,98484
20000,84,7349,7,176769,260395,83626
20000,67,7438,7,228421,233932,5511
20000,267,7502,8,241259,314128,72869
20000,202,7394,7,175072,238858,63786
20000,156,7322,7,199288,256509,57221
20000,170,7371,7,196163,261725,65562
20000,134,7321,7,212026,243113,31087
20000,144,7273,7,198171,270147,71976
20000,195,7417,7,264924,306590,41666
20000,7,7335,6,235674,251569,15895
20000,418,7274,7,205920,264509,58589
20000,201,7403,7,233880,252725,18845
21000,223,7764,7,264058,283941,19883
21000,288,7761,7,227724,298864,71140
21000,156,7738,7,240850,267226,26376
21000,32,7706,7,208132,234722,26590
21000,193,7807,7,184529,249212,64683
21000,240,7774,6,198707,282420,83713
21000,116,7737,7,207902,272312,64410
21000,111,7731,7,215243,318412,103169
21000,85,7753,8,236401,260052,23651
21000,149,7756,7,226235,272558,46323
21000,219,7722,6,197936,262461,64525
21000,78,7722,8,261855,266039,4184
21000,104,7717,7,271025,294565,23540
21000,164,7764,7,182721,291025,108304
21000,51,7702,7,225110,277096,51986
21000,44,7752,7,250039,264170,14131
21000,90,7737,7,279749,288626,8877
21000,226,7760,6,246068,315897,69829
21000,280,7775,8,203404,261590,58186
21000,150,7706,6,196928,283686,86758
21000,238,7641,7,227757,273479,45722
21000,212,7779,7,224707,320352,95645
21000,174,7731,7,193438,259760,66322
21000,299,7650,8,198198,266955,68757
21000,236,7710,7,234468,278715,44247
21000,275,7733,7,272469,293819,21350
21000,250,7659,7,195757,289500,93743
21000,278,7723,7,214492,261648,47156
21000,244,7664,6,197762,279603,81841
21000,58,7739,7,214032,262016,47984
21000,157,7708,6,225301,245257,19956
21000,213,7704,6,237705,288134,50429
21000,301,7676,6,248433,290578,42145
21000,386,7783,7,218638,267222,48584
21000,169,7712,6,248473,277939,29466
21000,150,7758,9,241754,292910,51156
21000,216,7861,7,210296,320667,110371
21000,133,7667,7,192369,277356,84987
21000,97,7735,8,224311,252548,28237
21000,278,7723,9,208163,268274,60111
21000,240,7714,7,243400,312776,69376
21000,90,7808,8,207225,308376,101151
21000,309,7838,8,204184,249673,45489
21000,133,7706,8,257786,284938,27152
21000,425,7765,6,273301,307584,34283
21000,147,7690,7,182407,290804,108397
21000,300,7721,7,240904,250318,9414
21000,79,7729,7,222632,281726,59094
21000,171,7758,7,216900,282234,65334
21000,24,7797,7,208566,258200,49634
22000,139,8024,7,203760,254500,50740
22000,64,8070,7,210356,252907,42551
22000,67,8173,6,190373,251983,61610
22000,413,8043,7,210811,287174,76363
22000,190,8169,8,242023,273846,31823
22000,277,8017,7,224338,255775,31437
22000,200,8019,7,243620,252385,8765
22000,82,8132,7,260442,289931,29489
22000,63,8042,7,209079,274507,65428
22000,110,8039,6,190631,325979,135348
22000,145,8068,8,204443,320034,115591
22000,184,8066,7,214413,308608,94195
22000,210,8173,6,222226,252841,30615
22000,243,8109,7,285651,313549,27898
22000,236,8109,7,247927,280845,32918
22000,117,8097,7,230126,266164,36038
22000,87,8105,7,205165,272216,67051
22000,236,8152,6,221275,262667,41392
22000,133,8117,7,218473,303591,85118
22000,245,8048,8,225587,290225,64638
22000,301,8113,6,238111,260331,22220
22000,79,8079,6,216972,342749,125777
22000,93,8154,7,224185,283496,59311
22000,409,8157,7,240200,275776,35576
22000,162,8125,7,200032,333811,133779
22000,151,8126,7,220286,394245,173959
22000,367,8064,8,225307,270722,45415
22000,109,8032,7,244248,312405,68157
22000,401,8068,6,273146,285031,11885
22000,269,7931,7,200257,279608,79351
22000,328,8037,6,257565,290078,32513
22000,205,8086,7,249078,302296,53218
22000,158,8042,7,274647,298755,24108
22000,362,8118,7,242030,304053,62023
22000,153,7958,7,233786,266768,32982
22000,104,8053,7,230049,300231,70182
22000,224,8099,6,220352,359882,139530
22000,210,8135,7,239252,263030,23778
22000,115,8080,7,213530,326932,113402
22000,114,8163,7,244161,251061,6900
22000,195,8115,7,221864,267257,45393
22000,32,7971,8,194508,324450,129942
22000,44,8178,8,272484,307470,34986
22000,60,8136,7,199760,290354,90594
22000,246,8105,7,322645,335660,13015
22000,110,8107,6,206686,313504,106818
22000,496,8046,7,229085,271565,42480
22000,256,8092,7,205688,247957,42269
22000,169,8050,7,228630,279698,51068
22000,40,8125,7,262529,291474,28945
23000,67,8548,7,227847,294006,66159
23000,120,8378,7,235447,292665,57218
23000,180,8344,7,228185,279260,51075
23000,80,8456,7,298155,309702,11547
23000,155,8444,6,252780,274734,21954
23000,120,8482,7,243566,335328,91762
23000,105,8409,8,200948,273696,72748
23000,288,8516,7,212370,269008,56638
23000,212,8370,7,225329,275009,49680
23000,136,8503,7,241242,276604,35362
23000,153,8381,7,308531,362016,53485
23000,70,8541,7,297181,331055,33874
23000,68,8499,7,207605,303704,96099
23000,404,8494,7,286623,334106,47483
23000,126,8568,7,218432,320940,102508
23000,121,8397,7,301127,316586,15459
23000,328,8372,7,252962,375158,122196
23000,115,8481,7,260110,286136,26026
23000,135,8504,8,227865,264544,36679
23000,152,8467,7,209684,280139,70455
23000,517,8410,7,235114,302631,67517
23000,210,8484,6,288519,309674,21155
23000,286,8423,6,210859,266761,55902
23000,181,8462,7,258859,300915,42056
23000,149,8529,7,325966,350399,24433
23000,113,8415,7,255910,329632,73722
23000,177,8427,6,217904,272922,55018
23000,85,8454,8,215875,271427,55552
23000,311,8453,8,240091,281086,40995
23000,184,8469,7,224019,303275,79256
23000,343,8490,8,240807,292063,51256
23000,294,8413,7,205379,250347,44968
23000,88,8360,7,202812,297446,94634
23000,333,8529,7,225391,346255,120864
23000,125,8491,7,264835,341378,76543
23000,240,8471,7,234771,285587,50816
23000,120,8522,7,246428,296266,49838
23000,240,8420,6,215359,302813,87454
23000,127,8399,7,235471,275876,40405
23000,300,8452,6,236533,257462,20929
23000,109,8436,7,217584,292315,74731
23000,168,8459,6,280323,330881,50558
23000,42,8484,7,229476,356542,127066
23000,129,8503,8,217894,288968,71074
23000,94,8467,7,229082,348164,119082
23000,114,8489,8,247640,295172,47532
23000,140,8555,7,281664,332708,51044
23000,172,8508,7,216935,287183,70248
23000,124,8551,7,301110,353360,52250
23000,190,8459,6,289531,322806,33275
24000,365,8794,7,284588,296968,12380
24000,314,8719,7,242657,281878,39221
24000,133,8879,7,306963,308887,1924
24000,142,8782,6,243795,288767,44972
24000,148,8842,7,232166,306278,74112
24000,146,8764,8,234532,294181,59649
24000,56,8805,7,241596,289582,47986
24000,111,8859,7,263302,414685,151383
24000,228,8970,7,293705,299263,5558
24000,328,8787,7,238960,300581,61621
24000,255,8849,7,274577,302037,27460
24000,152,8830,6,280290,368170,87880
24000,88,8784,6,283625,318950,35325
24000,35,8913,9,331176,334903,3727
24000,371,8848,7,208072,293224,85152
24000,180,8764,7,294843,336833,41990
24000,237,8798,6,261742,342099,80357
24000,115,8820,7,268848,282370,13522
24000,126,8931,7,247446,302321,54875
24000,148,8875,7,271485,312131,40646
24000,181,8794,7,216316,305207,88891
24000,365,8873,7,259499,305792,46293
24000,177,8835,7,312317,366061,53744
24000,249,8745,7,212178,286117,73939
24000,190,8814,7,253607,293218,39611
24000,357,8776,7,303489,338959,35470
24000,222,8841,7,297343,335335,37992
24000,113,8848,7,293387,360233,66846
24000,194,8906,6,293758,296631,2873
24000,173,8849,8,322709,343802,21093
24000,331,8788,8,230370,274851,44481
24000,141,8784,8,272062,313923,41861
24000,8,8887,9,239549,294025,54476
24000,287,8824,7,214602,306176,91574
24000,101,8824,6,347142,377533,30391
24000,95,8839,7,305749,310135,4386
24000,284,8799,6,236867,313893,77026
24000,72,8873,6,270205,308424,38219
24000,76,8861,7,244482,278823,34341
24000,122,8789,8,258940,320792,61852
24000,14,8884,7,278052,305017,26965
24000,121,8845,6,235130,327844,92714
24000,209,8848,7,215468,323780,108312
24000,68,8883,7,300745,331521,30776
24000,274,8821,8,289313,343437,54124
24000,244,8860,8,265983,324543,58560
24000,327,8774,7,235838,291890,56052
24000,115,8814,8,259170,302831,43661
24000,231,8852,7,312628,354355,41727
24000,25,8865,7,254117,314259,60142
25000,146,9214,7,218416,344036,125620
25000,97,9219,7,254827,322457,67630
25000,155,9159,7,237602,362221,124619
25000,383,9127,7,263688,373324,109636
25000,219,9217,7,257686,338960,81274
25000,112,9165,7,304631,347418,42787
25000,108,9284,9,243406,313869,70463
25000,157,9259,6,294211,333152,38941
25000,205,9164,8,251716,375372,123656
25000,351,9167,8,238346,309201,70855
25000,201,9132,7,285033,352811,67778
25000,409,9218,7,270420,329450,59030
25000,263,9166,7,251975,336427,84452
25000,119,9164,7,261333,380482,119149
25000,252,9172,7,302727,355144,52417
25000,260,9181,8,271325,286959,15634
25000,56,9148,7,286376,318254,31878
25000,43,9126,7,234365,323804,89439
25000,78,9168,8,258473,320564,62091
25000,249,9212,7,291233,313837,22604
25000,317,9172,7,262027,316737,54710
25000,96,9244,8,251870,334606,82736
25000,154,9134,8,290645,316598,25953
25000,96,9229,7,245100,322909,77809
25000,99,9159,7,264471,388957,124486
25000,394,9187,7,247956,315667,67711
25000,157,9175,7,241628,335339,93711
25000,185,9247,7,252352,334900,82548
25000,275,9215,7,333936,371112,37176
25000,192,9222,7,245189,318386,73197
25000,81,9195,7,258494,334525,76031
25000,255,9221,7,243236,280411,37175
25000,206,9199,6,245665,327272,81607
25000,420,9178,7,224907,283491,58584
25000,123,9183,7,252261,333042,80781
25000,191,9205,7,238148,395594,157446
25000,32,9256,7,242149,306654,64505
25000,120,9181,7,335278,340463,5185
25000,258,9228,8,258731,297517,38786
25000,92,9096,8,245178,312146,66968
25000,215,9128,8,278961,334250,55289
25000,106,9229,8,219005,369386,150381
25000,278,9150,7,240880,325732,84852
25000,258,9143,7,260143,324546,64403
25000,279,9214,8,287160,312686,25526
25000,92,9213,7,286073,370163,84090
25000,67,9156,7,251889,291574,39685
25000,142,9254,8,241416,334734,93318
25000,530,9253,7,246842,315398,68556
25000,291,9202,7,299415,423902,124487
26000,310,9599,7,256051,300072,44021
26000,149,9496,7,267308,431239,163931
26000,106,9632,7,264139,327884,63745
26000,35,9567,8,248468,319324,70856
26000,196,9572,7,266157,295991,29834
26000,441,9629,8,268306,319167,50861
26000,66,9662,7,241870,291436,49566
26000,37,9583,8,306247,318903,12656
26000,315,9521,7,297362,372517,75155
26000,446,9541,7,264498,370904,106406
26000,324,9640,6,251547,425825,174278
26000,331,9542,7,253392,337789,84397
26000,462,9697,6,338585,419007,80422
26000,182,9522,7,296505,320221,23716
26000,261,9651,8,259728,360420,100692
26000,84,9610,6,282902,321924,39022
26000,62,9449,7,308719,327949,19230
26000,314,9599,7,282979,321385,38406
26000,226,9565,7,293590,299572,5982
26000,278,9487,8,289235,341712,52477
26000,147,9637,8,238274,387211,148937
26000,250,9601,7,303351,384277,80926
26000,260,9544,7,248302,322469,74167
26000,386,9534,7,284823,298903,14080
26000,402,9560,6,233661,297181,63520
26000,387,9547,7,275610,334510,58900
26000,247,9551,7,247334,326739,79405
26000,257,9545,8,260852,320202,59350
26000,420,9578,9,248165,339814,91649
26000,265,9566,7,291146,358644,67498
26000,163,9515,7,258438,315665,57227
26000,101,9588,7,243978,360596,116618
26000,146,9671,7,391851,393614,1763
26000,119,9672,7,265068,309310,44242
26000,164,9566,8,301023,374127,73104
26000,278,9582,7,225875,354653,128778
26000,355,9558,7,345626,346215,589
26000,186,9620,8,262482,374283,111801
26000,421,9582,8,325898,331138,5240
26000,249,9496,8,281411,304586,23175
26000,193,9460,8,230679,605470,374791
26000,214,9682,6,328512,340492,11980
26000,286,9620,7,270641,317973,47332
26000,85,9587,8,234331,330457,96126
26000,72,9546,6,266921,338250,71329
26000,149,9529,6,262990,356827,93837
26000,146,9535,7,276000,332734,56734
26000,188,9530,8,276473,354623,78150
26000,154,9569,6,275333,303505,28172
26000,54,9584,7,269413,372080,102667
27000,407,9896,6,307565,355272,47707
27000,177,9893,7,330627,397700,67073
27000,271,9911,8,278767,391309,112542
27000,73,9924,6,431003,441001,9998
27000,92,9968,8,339257,352265,13008
27000,46,10003,7,259443,354519,95076
27000,279,9926,7,281263,340028,58765
27000,306,9977,7,275994,346106,70112
27000,338,9930,7,376895,398749,21854
27000,42,9904,7,407577,427071,19494
27000,144,10008,8,277148,366857,89709
27000,211,9928,7,247948,364861,116913
27000,362,9932,7,276901,348009,71108
27000,38,9897,8,292271,384826,92555
27000,179,10038,7,259073,348603,89530
27000,155,9931,7,306208,419204,112996
27000,189,9944,8,264383,369555,105172
27000,294,9909,7,255032,337239,82207
27000,103,9934,7,235853,432635,196782
27000,359,9888,7,269067,373642,104575
27000,117,9921,7,244275,305647,61372
27000,97,9924,7,282343,401393,119050
27000,175,9973,7,323345,324570,1225
27000,122,9831,7,270865,335716,64851
27000,231,10011,7,263477,319334,55857
27000,50,9837,6,248462,347878,99416
27000,329,9948,9,286318,385206,98888
27000,184,9895,8,241443,348082,106639
27000,60,9983,7,335370,405171,69801
27000,460,9925,7,268711,365468,96757
27000,138,9892,8,288254,362194,73940
27000,252,9921,7,279756,361016,81260
27000,342,10020,7,274244,371955,97711
27000,383,9922,6,246931,354121,107190
27000,96,9985,7,292351,440966,148615
27000,204,9945,9,381247,388206,6959
27000,172,9884,7,263205,319159,55954
27000,171,9917,8,271711,309477,37766
27000,309,9875,7,251339,440170,188831
27000,91,9941,7,266143,330092,63949
27000,130,9970,7,281573,365622,84049
27000,334,9999,7,275340,324329,48989
27000,189,9953,7,299958,354667,54709
27000,254,9984,7,301761,391488,89727
27000,161,9905,6,319153,386029,66876
27000,236,9885,8,381144,386202,5058
27000,223,9988,8,271035,360030,88995
27000,398,9939,7,309162,359705,50543
27000,441,9981,7,301393,338143,36750
27000,139,9913,7,311826,329361,17535
28000,139,10244,8,276865,380805,103940
28000,295,10213,7,316203,433296,117093
28000,193,10307,7,312294,349673,37379
28000,133,10364,6,272230,331470,59240
28000,70,10346,7,280359,395676,115317
28000,174,10276,6,276122,365705,89583
28000,120,10309,8,289988,344342,54354
28000,213,10340,9,394994,422698,27704
28000,321,10284,7,287299,372494,85195
28000,97,10271,8,251934,328430,76496
28000,260,10360,7,321196,343576,22380
28000,253,10311,7,256336,357306,100970
28000,239,10278,6,271922,392333,120411
28000,362,10244,7,334590,372054,37464
28000,236,10349,7,265363,431572,166209
28000,55,10273,8,299169,352826,53657
28000,161,10293,7,260561,389424,128863
28000,182,10278,8,315559,398418,82859
28000,66,10330,7,293937,439561,145624
28000,216,10354,7,284992,322888,37896
28000,163,10229,7,309618,346095,36477
28000,112,10293,8,320222,415323,95101
28000,92,10318,7,363937,390337,26400
28000,382,10303,7,291147,382364,91217
28000,169,10312,7,277534,403301,125767
28000,243,10303,7,342597,388796,46199
28000,229,10227,7,346207,442896,96689
28000,422,10354,7,258868,395318,136450
28000,441,10301,7,277833,387500,109667
28000,165,10192,9,330550,436722,106172
28000,236,10337,8,298417,408133,109716
28000,204,10283,7,261992,346894,84902
28000,130,10224,8,290475,317324,26849
28000,251,10321,7,304399,407756,103357
28000,40,10294,8,285231,374095,88864
28000,488,10344,8,330825,397042,66217
28000,484,10272,8,288886,333162,44276
28000,96,10308,7,277603,399832,122229
28000,225,10316,7,258710,342668,83958
28000,307,10391,7,373993,515912,141919
28000,151,10329,8,304338,344283,39945
28000,132,10328,7,294806,330815,36009
28000,394,10275,6,344118,393934,49816
28000,153,10308,7,279705,318437,38732
28000,28,10176,7,326465,425842,99377
28000,196,10262,7,280146,358269,78123
28000,108,10302,8,258869,329105,70236
28000,142,10334,7,329208,360883,31675
28000,186,10210,8,356039,371271,15232
28000,218,10304,7,326352,402899,76547
29000,249,10642,7,291241,371514,80273
29000,217,10658,8,293419,367625,74206
29000,183,10655,8,334484,381295,46811
29000,159,10685,7,312382,498190,185808
29000,91,10770,7,295660,387580,91920
29000,194,10554,8,287970,376323,88353
29000,240,10667,7,323064,374503,51439
29000,181,10585,6,309323,367739,58416
29000,120,10732,7,289963,397014,107051
29000,166,10630,9,320258,461571,141313
29000,277,10671,7,291853,606423,314570
29000,193,10601,6,329693,498816,169123
29000,144,10668,7,377579,408728,31149
29000,203,10741,8,292531,350273,57742
29000,349,10678,7,294605,421584,126979
29000,220,10652,7,283463,374729,91266
29000,117,10661,7,362247,452271,90024
29000,273,10617,8,346337,348684,2347
29000,395,10690,7,281650,353938,72288
29000,179,10731,7,276831,341677,64846
29000,137,10648,8,302697,478664,175967
29000,217,10651,8,289469,378078,88609
29000,371,10717,7,287237,358023,70786
29000,227,10675,7,325853,394445,68592
29000,79,10643,7,300909,380667,79758
29000,198,10618,7,280893,378821,97928
29000,207,10608,7,349704,406492,56788
29000,325,10789,7,297636,369908,72272
29000,247,10653,7,297829,414669,116840
29000,341,10696,7,301044,387229,86185
29000,76,10589,7,286367,428172,141805
29000,257,10632,8,282147,363027,80880
29000,25,10569,7,291293,435721,144428
29000,442,10694,8,334773,423576,88803
29000,189,10667,6,308890,444596,135706
29000,83,10692,7,443787,488965,45178
29000,287,10643,7,363854,369445,5591
29000,384,10630,7,238020,375187,137167
29000,51,10693,7,277766,335282,57516
29000,97,10733,8,296394,354219,57825
29000,219,10607,8,358419,378183,19764
29000,65,10623,7,287864,390870,103006
29000,203,10633,7,285500,366827,81327
29000,170,10641,7,281005,336010,55005
29000,173,10655,8,305983,364270,58287
29000,304,10633,6,316381,347526,31145
29000,45,10762,7,298396,377820,79424
29000,356,10649,8,356177,481153,124976
29000,231,10621,8,313765,341060,27295
29000,463,10716,7,312817,370626,57809
30000,98,11091,7,287344,418343,130999
30000,167,10976,8,335442,390098,54656
30000,188,11080,10,290269,363794,73525
30000,96,11013,8,296608,384063,87455
30000,119,10892,7,403011,454270,51259
30000,347,11026,7,388188,461242,73054
30000,134,11019,7,271789,361885,90096
30000,262,11082,8,309238,362922,53684
30000,327,10961,7,307457,456753,149296
30000,144,11097,7,308782,416474,107692
30000,34,10910,7,345635,428705,83070
30000,342,10998,7,414633,422626,7993
30000,287,11012,6,351631,451555,99924
30000,179,10964,7,319481,401376,81895
30000,44,11048,7,295945,354452,58507
30000,142,10945,7,304625,387021,82396
30000,237,10976,7,360345,446721,86376
30000,308,11053,7,290190,400632,110442
30000,175,11000,7,302628,413953,111325
30000,86,11008,7,287167,434596,147429
30000,77,10986,8,380495,389785,9290
30000,167,11093,6,324376,370869,46493
30000,196,11040,7,318037,396498,78461
30000,116,11072,8,351637,427622,75985
30000,358,11072,7,371161,394452,23291
30000,172,11139,7,290300,378042,87742
30000,597,11006,7,346445,402510,56065
30000,377,11049,7,347235,366079,18844
30000,237,10990,8,311340,391566,80226
30000,269,10992,8,356807,452281,95474
30000,257,11017,7,311185,358720,47535
30000,74,11088,7,282629,373038,90409
30000,249,10950,8,444076,504505,60429
30000,354,10998,7,296312,353684,57372
30000,209,11007,7,315856,379423,63567
30000,379,11008,7,364583,484147,119564
30000,453,10982,6,295222,359862,64640
30000,189,11030,8,283845,404041,120196
30000,195,11010,7,456912,504718,47806
30000,104,11071,9,301716,408065,106349
30000,164,11012,7,370755,398298,27543
30000,447,11042,8,316887,413375,96488
30000,282,11130,7,310533,358966,48433
30000,304,11054,7,344494,404592,60098
30000,228,10981,7,317911,415456,97545
30000,277,11032,7,286768,429812,143044
30000,339,11047,8,311558,388221,76663
30000,150,11075,7,336227,396034,59807
30000,89,11025,9,272237,383968,111731
30000,61,11002,7,283010,396653,113643
31000,306,11396,7,335848,409865,74017
31000,383,11350,6,326411,418006,91595
31000,114,11364,6,323738,422059,98321
31000,163,11336,7,350214,403608,53394
31000,192,11459,8,298071,393982,95911
31000,397,11367,7,325181,448005,122824
31000,466,11369,7,328834,390292,61458
31000,111,11326,7,294109,416040,121931
31000,242,11377,8,349839,416893,67054
31000,237,11504,9,306231,374597,68366
31000,191,11423,7,399163,403973,4810
31000,79,11412,7,359911,441648,81737
31000,297,11399,6,458131,491754,33623
31000,96,11358,8,308642,340755,32113
31000,438,11392,7,327541,458797,131256
31000,286,11404,8,311574,389394,77820
31000,244,11516,7,299504,410699,111195
31000,31,11379,7,321681,393642,71961
31000,303,11325,7,382177,524347,142170
31000,260,11394,8,356230,417264,61034
31000,306,11397,9,348394,351851,3457
31000,65,11382,8,273393,372217,98824
31000,129,11498,8,282381,413237,130856
31000,315,11483,7,329444,446140,116696
31000,251,11396,8,328208,394105,65897
31000,197,11447,7,327886,437592,109706
31000,227,11333,7,318564,398034,79470
31000,99,11371,7,311758,429494,117736
31000,334,11467,7,339606,426401,86795
31000,199,11477,7,325008,391815,66807
31000,204,11431,7,320091,488396,168305
31000,333,11475,7,305756,475082,169326
31000,129,11398,7,342667,405308,62641
31000,194,11374,7,292580,391631,99051
31000,116,11378,6,344011,377652,33641
31000,379,11513,7,350660,369452,18792
31000,136,11351,8,304554,464886,160332
31000,202,11438,8,399960,456073,56113
31000,147,11428,8,325723,448869,123146
31000,235,11439,8,342910,434463,91553
31000,40,11454,8,382438,510132,127694
31000,201,11373,7,315783,405789,90006
31000,281,11408,7,340227,447376,107149
31000,231,11330,7,444195,450801,6606
31000,78,11362,7,342067,444205,102138
31000,145,11477,8,309800,382843,73043
31000,203,11347,7,331150,449245,118095
31000,220,11422,7,385592,403650,18058
31000,88,11396,7,427204,456840,29636
31000,305,11369,7,337996,432843,94847
32000,80,11744,7,321779,391873,70094
32000,305,11811,8,484681,490764,6083
32000,236,11786,8,301880,405289,103409
32000,146,11767,8,384283,486681,102398
32000,203,11827,7,315317,531948,216631
32000,404,11793,7,359076,387657,28581
32000,262,11733,8,305798,487043,181245
32000,331,11762,7,376132,444851,68719
32000,350,11777,7,372956,516628,143672
32000,256,11746,6,352655,432481,79826
32000,100,11781,8,297641,406598,108957
32000,94,11754,8,340914,465615,124701
32000,203,11741,9,318978,421490,102512
32000,50,11696,7,360260,528068,167808
32000,108,11862,8,322883,433694,110811
32000,515,11846,8,328232,379291,51059
32000,80,11807,8,403460,524780,121320
32000,243,11781,7,393550,403429,9879
32000,304,11815,9,435108,512047,76939
32000,340,11791,7,299066,390227,91161
32000,151,11757,7,382152,450015,67863
32000,284,11779,7,343596,508681,165085
32000,243,11735,7,363578,499147,135569
32000,132,11738,7,395097,451355,56258
32000,227,11805,8,334797,397069,62272
32000,242,11785,8,312236,404907,92671
32000,219,11840,8,416044,472620,56576
32000,213,11675,7,329422,450650,121228
32000,70,11764,7,439209,455007,15798
32000,455,11773,7,364099,417700,53601
32000,276,11861,8,364452,411632,47180
32000,261,11784,7,308324,424357,116033
32000,355,11701,8,291471,408529,117058
32000,148,11845,8,421614,449504,27890
32000,315,11776,7,331461,358441,26980
32000,170,11838,7,304436,454391,149955
32000,184,11769,7,332467,396402,63935
32000,258,11827,7,358038,401966,43928
32000,210,11747,8,371168,457097,85929
32000,151,11790,7,331890,402785,70895
32000,213,11760,7,304962,408901,103939
32000,197,11797,8,345677,502787,157110
32000,122,11733,7,442934,485979,43045
32000,129,11844,7,343361,362308,18947
32000,84,11652,8,310748,403349,92601
32000,49,11750,8,366864,439962,73098
32000,67,11713,7,343196,425907,82711
32000,313,11709,6,372706,457775,85069
32000,378,11759,7,311293,439975,128682
32000,317,11807,7,360076,488195,128119
33000,163,12060,7,378295,438066,59771
33000,37,12125,7,334726,433596,98870
33000,215,12069,7,338825,484572,145747
33000,101,12128,7,335119,386385,51266
33000,463,12063,7,348340,401469,53129
33000,78,12137,7,362523,380977,18454
33000,196,12161,7,316293,420281,103988
33000,111,12175,7,467280,492312,25032
33000,306,12106,7,353923,460139,106216
33000,232,12135,7,440037,441631,1594
33000,153,12161,7,357706,589945,232239
33000,329,12185,7,316948,489492,172544
33000,236,12197,8,337716,384335,46619
33000,222,12182,7,363443,471551,108108
33000,297,12170,7,348473,386710,38237
33000,126,12114,8,373628,428962,55334
33000,203,12118,7,335344,570900,235556
33000,179,12068,7,384212,419945,35733
33000,95,12196,7,393161,465945,72784
33000,112,12120,7,318496,411905,93409
33000,207,12079,9,334498,466482,131984
33000,281,12050,7,327964,455045,127081
33000,223,12069,7,358038,437475,79437
33000,441,12111,7,371577,404082,32505
33000,623,12219,7,347264,438187,90923
33000,234,12118,7,335747,424850,89103
33000,405,12169,6,420056,552310,132254
33000,363,12040,7,349652,416152,66500
33000,53,12077,7,380214,430964,50750
33000,303,12149,7,352699,385296,32597
33000,105,12113,7,390014,429302,39288
33000,486,12132,7,403668,518683,115015
33000,98,12133,7,350003,533864,183861
33000,238,12068,7,333776,466910,133134
33000,367,12117,8,360592,420603,60011
33000,249,12181,7,342466,395908,53442
33000,193,12070,7,350996,447944,96948
33000,193,12126,8,347882,454364,106482
33000,48,12074,8,423647,487731,64084
33000,246,12231,7,365285,401306,36021
33000,49,12165,7,354227,400351,46124
33000,277,12266,8,365657,395062,29405
33000,189,12088,8,335135,414657,79522
33000,489,12217,7,328446,482590,154144
33000,142,12113,7,357157,480981,123824
33000,213,12088,7,367380,388263,20883
33000,40,12060,8,391287,493344,102057
33000,237,12277,8,322011,397744,75733
33000,174,12104,8,372967,416583,43616
33000,396,12146,9,409436,504288,94852
34000,167,12410,7,402772,450860,48088
34000,30,12491,7,363411,461710,98299
34000,178,12452,6,394268,436410,42142
34000,396,12481,7,356659,431928,75269
34000,51,12592,7,359371,429830,70459
34000,258,12539,7,362942,607417,244475
34000,79,12439,7,320260,405740,85480
34000,404,12519,6,341001,480036,139035
34000,164,12441,7,341536,509308,167772
34000,194,12432,7,346767,517659,170892
34000,200,12467,7,347306,474065,126759
34000,394,12519,7,374938,466867,91929
34000,297,12449,7,334813,469883,135070
34000,345,12497,7,387191,442938,55747
34000,211,12527,7,322256,406742,84486
34000,55,12534,7,457490,502145,44655
34000,348,12576,7,424478,471883,47405
34000,70,12611,6,352358,445418,93060
34000,177,12444,7,527137,538398,11261
34000,230,12581,8,387752,518949,131197
34000,182,12571,7,322495,464483,141988
34000,263,12485,7,346455,428498,82043
34000,188,12566,7,443679,463031,19352
34000,268,12477,7,361044,440261,79217
34000,426,12449,8,359839,404813,44974
34000,326,12447,7,437619,590266,152647
34000,364,12575,8,311127,390526,79399
34000,55,12485,6,395729,526893,131164
34000,142,12430,8,334572,395157,60585
34000,86,12521,7,342310,411416,69106
34000,283,12449,7,365853,437961,72108
34000,133,12411,6,429781,450637,20856
34000,67,12607,7,310117,451073,140956
34000,134,12596,7,470195,484655,14460
34000,148,12484,7,405225,492244,87019
34000,232,12590,7,309359,459301,149942
34000,180,12505,6,447791,455981,8190
34000,488,12521,7,351402,446201,94799
34000,317,12538,7,322820,489887,167067
34000,214,12504,8,413528,452412,38884
34000,207,12525,7,386735,465980,79245
34000,277,12520,7,342722,443316,100594
34000,190,12522,8,369238,449190,79952
34000,74,12463,7,377946,422216,44270
34000,161,12474,7,304532,496106,191574
34000,186,12457,7,376324,473602,97278
34000,101,12530,8,364929,436847,71918
34000,226,12443,7,366307,459933,93626
34000,94,12537,7,417053,427311,10258
34000,297,12404,7,318249,504595,186346
35000,269,12930,8,320070,432953,112883
35000,164,12933,7,402487,495647,93160
35000,140,12854,7,340485,432793,92308
35000,308,12790,7,332574,428251,95677
35000,442,12881,7,361018,433133,72115
35000,136,12852,7,509590,573193,63603
35000,348,13008,7,338493,517404,178911
35000,349,12878,7,364914,484871,119957
35000,407,12838,7,335476,493202,157726
35000,288,12854,9,358356,463418,105062
35000,142,12907,8,356432,501014,144582
35000,161,12916,7,384137,534457,150320
35000,339,12829,8,319192,406504,87312
35000,247,12815,7,379764,457411,77647
35000,225,12909,6,417819,464983,47164
35000,73,12867,8,364743,549246,184503
35000,353,12848,8,387482,425084,37602
35000,102,12860,7,402740,496774,94034
35000,85,12921,8,385525,413964,28439
35000,296,12947,7,353741,515104,161363
35000,60,12853,7,344759,443852,99093
35000,426,12901,8,485916,550906,64990
35000,93,12870,8,352906,463234,110328
35000,290,13008,7,383596,452593,68997
35000,99,12787,7,324168,497616,173448
35000,370,12902,7,487197,509782,22585
35000,225,12916,7,386475,465080,78605
35000,244,12906,7,405528,536347,130819
35000,327,12943,7,341385,576675,235290
35000,222,12874,7,482055,505260,23205
35000,212,12882,7,379956,425533,45577
35000,170,12893,7,363846,448694,84848
35000,251,12863,7,373468,454432,80964
35000,185,12891,7,475134,488645,13511
35000,99,12872,7,360650,430398,69748
35000,146,12863,7,438631,494964,56333
35000,441,12922,7,360145,455238,95093
35000,233,12907,7,367527,477788,110261
35000,237,12892,7,361577,485671,124094
35000,197,12906,7,606644,607736,1092
35000,162,12892,7,495709,559280,63571
35000,126,12881,7,358606,443762,85156
35000,290,12971,7,532429,564520,32091
35000,295,13006,7,341080,465020,123940
35000,387,12829,8,351050,423042,71992
35000,111,12936,7,413494,561232,147738
35000,112,12898,8,363437,476734,113297
35000,260,12883,7,352902,468503,115601
35000,46,12963,7,355396,585045,229649
35000,327,12882,7,378884,468854,89970
36000,340,13272,8,361046,510238,149192
36000,460,13226,8,438078,549387,111309
36000,268,13230,8,384082,526693,142611
36000,305,13272,8,345566,466030,120464
36000,54,13252,7,431633,471330,39697
36000,163,13206,6,478030,486045,8015
36000,202,13322,8,372433,444141,71708
36000,497,13153,8,456303,488529,32226
36000,372,13337,7,413799,458482,44683
36000,345,13212,8,377515,539450,161935
36000,157,13273,7,402656,524787,122131
36000,90,13302,7,362425,476508,114083
36000,158,13254,7,385578,441166,55588
36000,199,13231,8,417287,460126,42839
36000,221,13209,8,459821,486397,26576
36000,131,13231,7,369761,465222,95461
36000,248,13301,8,409035,489775,80740
36000,240,13268,8,439542,498542,59000
36000,323,13136,7,342453,426959,84506
36000,239,13168,7,395192,492769,97577
36000,319,13258,7,408238,552757,144519
36000,102,13319,7,374046,452901,78855
36000,218,13349,7,429546,441070,11524
36000,344,13258,7,460368,489519,29151
36000,343,13194,6,381016,497237,116221
36000,190,13314,7,352168,542458,190290
36000,233,13211,7,408758,453854,45096
36000,253,13080,7,473275,526628,53353
36000,135,13340,7,359815,529968,170153
36000,252,13377,7,357827,465699,107872
36000,187,13272,7,349044,423765,74721
36000,218,13326,7,443243,489732,46489
36000,314,13247,6,333995,451027,117032
36000,110,13221,8,353567,470414,116847
36000,143,13194,8,415627,640517,224890
36000,355,13336,7,374323,594711,220388
36000,259,13241,7,400777,536920,136143
36000,333,13283,8,388063,540984,152921
36000,131,13294,7,408930,547450,138520
36000,565,13141,7,363559,467491,103932
36000,232,13296,7,406651,573138,166487
36000,316,13283,9,371681,469512,97831
36000,161,13324,7,392142,434497,42355
36000,128,13326,7,391922,424167,32245
36000,88,13220,8,358595,414922,56327
36000,76,13215,9,353473,468058,114585
36000,318,13340,7,327141,395973,68832
36000,234,13238,7,418088,488503,70415
36000,246,13274,7,435101,493782,58681
36000,146,13226,8,339578,518701,179123
37000,293,13562,8,390821,486682,95861
37000,266,13557,7,375658,458129,82471
37000,155,13687,7,429267,506131,76864
37000,384,13658,7,384196,444984,60788
37000,202,13575,7,393970,482973,89003
37000,225,13612,7,374582,481554,106972
37000,268,13688,7,518608,539318,20710
37000,207,13550,7,363113,455310,92197
37000,354,13634,7,436022,541478,105456
37000,444,13582,8,368816,419548,50732
37000,49,13589,9,385089,523014,137925
37000,207,13609,7,404494,432921,28427
37000,287,13563,7,446978,565117,118139
37000,288,13557,8,395208,457416,62208
37000,241,13545,9,423169,533147,109978
37000,235,13573,7,352941,446898,93957
37000,391,13448,6,387964,476128,88164
37000,130,13633,7,480221,488868,8647
37000,323,13607,7,352976,477422,124446
37000,42,13565,7,400369,568576,168207
37000,255,13452,8,375067,556721,181654
37000,143,13597,7,528162,546864,18702
37000,72,13746,7,405638,510580,104942
37000,232,13576,7,375896,462890,86994
37000,68,13581,7,382775,663525,280750
37000,245,13601,9,380566,497213,116647
37000,237,13711,7,377625,530673,153048
37000,88,13687,7,383217,510508,127291
37000,106,13425,6,414684,608483,193799
37000,222,13746,7,448877,480734,31857
37000,265,13574,7,400636,476272,75636
37000,249,13530,7,422729,481548,58819
37000,322,13671,7,451939,488491,36552
37000,485,13597,7,405643,500137,94494
37000,236,13623,7,404445,481534,77089
37000,140,13603,7,412800,431318,18518
37000,348,13661,7,404165,557256,153091
37000,78,13673,8,458247,553304,95057
37000,71,13465,7,387089,449581,62492
37000,319,13560,7,437869,487420,49551
37000,88,13615,7,373599,485495,111896
37000,211,13668,7,369987,644357,274370
37000,292,13581,7,464075,530553,66478
37000,344,13705,7,402264,522361,120097
37000,241,13636,6,382809,517980,135171
37000,86,13625,8,397426,484274,86848
37000,201,13526,7,377290,551597,174307
37000,203,13666,8,355569,440317,84748
37000,172,13610,7,446540,501607,55067
37000,195,13662,9,352234,453536,101302
38000,201,13982,7,419856,557065,137209
38000,361,14024,8,464532,509743,45211
38000,121,13945,7,447229,639548,192319
38000,171,13924,7,483999,536272,52273
38000,227,13953,7,406210,456423,50213
38000,136,13958,7,419137,496050,76913
38000,222,14060,8,434107,536542,102435
38000,70,14014,8,396770,554099,157329
38000,182,13951,7,430349,479584,49235
38000,419,14036,7,413586,520217,106631
38000,129,13979,7,404432,478578,74146
38000,198,14036,7,418854,501923,83069
38000,257,13937,7,592889,642781,49892
38000,104,14038,7,460057,592940,132883
38000,404,13956,6,424701,551669,126968
38000,211,13902,9,426849,555898,129049
38000,239,14014,7,493665,502423,8758
38000,199,13914,8,416114,539799,123685
38000,37,13994,7,430103,433613,3510
38000,147,14019,8,436743,462513,25770
38000,268,14059,7,459723,541683,81960
38000,138,13942,8,440955,598681,157726
38000,231,14106,7,370956,577505,206549
38000,492,14045,7,384661,529757,145096
38000,238,13890,7,391415,448698,57283
38000,361,14014,8,353247,517583,164336
38000,218,14016,7,355664,485595,129931
38000,451,14037,7,431816,506486,74670
38000,94,13965,7,397420,478004,80584
38000,336,14004,7,403033,528833,125800
38000,22,13997,7,432065,586310,154245
38000,454,13952,7,401747,500095,98348
38000,310,13952,8,360528,437958,77430
38000,417,14060,8,492284,566727,74443
38000,272,13973,7,453418,470507,17089
38000,161,14002,7,426222,506835,80613
38000,141,13956,7,593726,626644,32918
38000,307,13951,7,406971,574308,167337
38000,179,14022,7,349449,681920,332471
38000,247,14055,8,434333,543892,109559
38000,142,14055,7,407940,477707,69767
38000,118,13955,7,409002,542918,133916
38000,237,13949,7,470519,511343,40824
38000,466,14005,8,465107,486787,21680
38000,244,13990,8,403994,618749,214755
38000,188,13909,7,466577,563798,97221
38000,225,13942,7,408453,528872,120419
38000,230,13952,8,450897,479783,28886
38000,298,13997,8,491590,654273,162683
38000,69,14152,7,378344,568731,190387
39000,70,14354,7,499614,572516,72902
39000,174,14344,7,406217,477665,71448
39000,147,14300,8,442184,505893,63709
39000,101,14372,10,491174,558726,67552
39000,177,14311,7,433287,504681,71394
39000,308,14452,9,497291,526473,29182
39000,247,14283,7,487247,786163,298916
39000,211,14371,8,374226,476833,102607
39000,211,14220,7,458585,557567,98982
39000,206,14437,7,451251,550031,98780
39000,262,14405,7,444480,628020,183540
39000,210,14280,7,522631,564171,41540
39000,263,14403,6,384898,462518,77620
39000,282,14326,7,339314,524717,185403
39000,296,14276,7,416905,542695,125790
39000,339,14369,8,399691,517189,117498
39000,384,14307,7,389372,482493,93121
39000,293,14355,7,473402,514302,40900
39000,254,14367,7,492353,521015,28662
39000,334,14235,7,438231,570936,132705
39000,144,14360,8,493456,619125,125669
39000,208,14297,8,364447,519398,154951
39000,158,14423,8,402294,536985,134691
39000,59,14317,7,550505,590165,39660
39000,445,14241,7,394072,518173,124101
39000,207,14327,7,431323,533893,102570
39000,389,14337,7,446187,515773,69586
39000,322,14458,7,418006,491352,73346
39000,477,14376,7,437671,466946,29275
39000,629,14260,7,392465,550627,158162
39000,163,14330,7,432463,521552,89089
39000,65,14332,7,451906,562140,110234
39000,174,14521,8,378128,482831,104703
39000,103,14415,7,355299,552979,197680
39000,208,14248,6,436387,590460,154073
39000,423,14309,7,422365,501115,78750
39000,310,14383,7,470441,514908,44467
39000,494,14331,8,357780,490654,132874
39000,231,14234,8,402739,483098,80359
39000,445,14380,8,423764,546623,122859
39000,246,14320,7,421614,482837,61223
39000,235,14401,7,381951,531974,150023
39000,72,14339,7,452437,491001,38564
39000,314,14253,7,387912,448596,60684
39000,306,14342,7,406895,512911,106016
39000,110,14343,8,501070,607301,106231
39000,190,14260,7,444495,483977,39482
39000,297,14345,8,501808,569375,67567
39000,515,14393,7,435638,516146,80508
39000,123,14320,7,426293,535635,109342
40000,354,14767,7,383705,497137,113432
40000,93,14687,7,466970,532334,65364
40000,265,14657,8,403001,514877,111876
40000,396,14771,9,605676,656473,50797
40000,357,14768,7,365809,623063,257254
40000,250,14762,8,440052,554841,114789
40000,313,14749,8,383526,546227,162701
40000,422,14819,8,406003,503446,97443
40000,370,14907,8,437700,500970,63270
40000,116,14790,7,453863,695552,241689
40000,303,14771,7,473891,605962,132071
40000,180,14693,7,434440,504966,70526
40000,115,14600,8,466327,506818,40491
40000,128,14672,8,407362,557541,150179
40000,199,14659,7,442467,495454,52987
40000,401,14706,9,461539,566664,105125
40000,168,14651,7,439051,484323,45272
40000,305,14733,7,487812,496886,9074
40000,69,14623,7,418397,565842,147445
40000,175,14656,8,474075,581529,107454
40000,168,14736,7,472894,543152,70258
40000,325,14625,8,415508,546304,130796
40000,205,14733,7,413843,474928,61085
40000,244,14620,8,409324,668084,258760
40000,478,14720,8,451129,484598,33469
40000,299,14621,7,378154,478255,100101
40000,214,14624,7,418888,549142,130254
40000,366,14631,6,391848,469150,77302
40000,18,14768,7,458794,548588,89794
40000,58,14615,7,433274,481431,48157
40000,367,14706,7,401738,512655,110917
40000,154,14800,7,425266,661004,235738
40000,166,14681,7,496995,524607,27612
40000,140,14715,8,395198,531319,136121
40000,161,14865,6,433998,542861,108863
40000,87,14681,7,511480,571625,60145
40000,454,14638,7,423076,558755,135679
40000,357,14769,8,433397,535075,101678
40000,265,14654,7,435646,545232,109586
40000,116,14656,8,380633,492594,111961
40000,269,14690,7,453269,612889,159620
40000,383,14722,7,551722,631766,80044
40000,180,14592,8,414055,541855,127800
40000,115,14724,7,453619,496425,42806
40000,265,14652,7,451201,553766,102565
40000,174,14738,7,534656,829831,295175
40000,298,14793,7,383598,522165,138567
40000,625,14700,7,405132,533426,128294
40000,522,14685,7,402488,593934,191446
40000,484,14699,7,419246,626418,207172
41000,315,15013,7,488462,647049,158587
41000,361,14995,8,476278,685254,208976
41000,258,15130,8,461014,584666,123652
41000,197,15023,7,579287,600515,21228
41000,398,15005,8,449851,584097,134246
41000,79,14947,8,521330,592693,71363
41000,204,15128,8,468964,530763,61799
41000,34,15046,7,463753,511774,48021
41000,470,14997,8,366297,467284,100987
41000,195,15035,8,455611,560762,105151
41000,371,14952,7,513640,614997,101357
41000,64,15100,7,453054,497149,44095
41000,105,15099,7,411464,529669,118205
41000,129,15000,8,495375,648065,152690
41000,476,15142,7,510653,621350,110697
41000,197,15018,7,446096,558211,112115
41000,253,15026,9,590957,707335,116378
41000,153,15127,8,536216,651447,115231
41000,602,15007,8,636321,666263,29942
41000,783,15029,9,407141,513104,105963
41000,213,15172,7,419348,524693,105345
41000,252,14953,8,656823,721936,65113
41000,174,15029,7,445286,574911,129625
41000,80,15041,8,449216,637258,188042
41000,342,14976,7,457599,627345,169746
41000,385,15116,7,416670,601292,184622
41000,56,15112,7,490330,601463,111133
41000,49,15163,7,430342,529524,99182
41000,224,15221,7,411887,500002,88115
41000,73,15066,8,473959,532292,58333
41000,177,14999,8,475493,670427,194934
41000,259,15007,7,430015,532645,102630
41000,157,15088,7,540191,551952,11761
41000,126,15141,7,520558,639419,118861
41000,186,15078,8,406926,509536,102610
41000,229,14982,8,427107,571481,144374
41000,192,14989,7,606211,642548,36337
41000,304,15171,7,409436,589857,180421
41000,146,15089,8,447734,588181,140447
41000,117,14925,7,496506,614189,117683
41000,347,15109,8,437195,648088,210893
41000,425,15075,7,396777,571357,174580
41000,686,15055,8,443913,469390,25477
41000,174,15037,7,484653,641166,156513
41000,52,15139,7,457474,482318,24844
41000,221,15155,7,480377,695669,215292
41000,218,15040,7,427741,517359,89618
41000,240,15091,7,445034,585056,140022
41000,60,15233,9,481436,552363,70927
41000,496,15194,7,444621,509001,64380
42000,426,15484,7,461101,663447,202346
42000,231,15559,8,416970,543105,126135
42000,195,15307,7,466098,579823,113725
42000,144,15416,7,452405,560132,107727
42000,326,15531,7,493425,551192,57767
42000,359,15505,7,473487,660294,186807
42000,341,15372,8,580265,590987,10722
42000,403,15455,7,472250,498080,25830
42000,241,15476,8,461859,621688,159829
42000,244,15551,7,441466,581004,139538
42000,517,15391,7,506463,629667,123204
42000,574,15447,8,410108,501982,91874
42000,566,15427,7,459841,633797,173956
42000,238,15537,7,472654,556355,83701
42000,410,15360,9,426397,595041,168644
42000,198,15571,7,519103,582066,62963
42000,32,15511,7,383155,598930,215775
42000,402,15382,8,444209,621346,177137
42000,425,15423,7,444892,599376,154484
42000,417,15426,8,501209,538117,36908
42000,68,15361,7,446445,563318,116873
42000,239,15469,7,389186,512906,123720
42000,257,15520,7,558936,659526,100590
42000,659,15508,7,416731,565273,148542
42000,196,15525,8,433946,490783,56837
42000,440,15347,6,447105,578273,131168
42000,212,15490,8,417678,544529,126851
42000,188,15260,8,397192,524776,127584
42000,187,15383,7,471323,556297,84974
42000,341,15393,7,396286,532566,136280
42000,34,15417,7,429904,564121,134217
42000,113,15455,8,487893,553526,65633
42000,175,15515,7,445149,543859,98710
42000,351,15440,7,440872,584162,143290
42000,531,15385,7,481343,613886,132543
42000,172,15469,7,476951,569312,92361
42000,347,15436,7,568184,619305,51121
42000,247,15601,7,504878,550793,45915
42000,134,15442,8,495030,669611,174581
42000,201,15417,7,516337,703018,186681
42000,63,15345,6,503484,579771,76287
42000,483,15554,7,480730,549926,69196
42000,150,15385,7,462403,554611,92208
42000,144,15494,8,496264,528693,32429
42000,431,15499,7,420164,552628,132464
42000,349,15401,7,485030,680620,195590
42000,155,15362,7,496483,572342,75859
42000,201,15617,8,451284,591785,140501
42000,85,15332,10,491838,687523,195685
42000,124,15481,7,510559,532226,21667
43000,296,15767,7,409599,598431,188832
43000,375,15942,9,505699,681021,175322
43000,133,15775,7,582091,617382,35291
43000,368,15902,7,543354,577212,33858
43000,605,15719,7,458716,552195,93479
43000,280,15708,7,467933,614644,146711
43000,178,15833,7,518319,618446,100127
43000,467,15811,7,434047,585973,151926
43000,79,15825,8,496863,649619,152756
43000,137,15789,7,469191,540940,71749
43000,339,15832,8,445159,568634,123475
43000,372,15756,7,441710,622644,180934
43000,237,15757,8,467395,517137,49742
43000,213,15787,7,479210,664348,185138
43000,715,15718,7,632300,685530,53230
43000,117,15766,8,410980,532563,121583
43000,291,15775,7,479833,539143,59310
43000,255,15869,7,453108,596200,143092
43000,156,15838,7,428892,533125,104233
43000,529,15733,7,432493,524306,91813
43000,219,15828,7,429921,514276,84355
43000,318,15759,8,471514,664024,192510
43000,99,15806,7,450859,572328,121469
43000,138,15793,9,411111,615869,204758
43000,274,15859,7,430712,533006,102294
43000,234,15816,7,569036,603071,34035
43000,104,15817,8,446548,531692,85144
43000,241,15865,7,481722,630677,148955
43000,205,15746,9,424847,686544,261697
43000,284,15772,7,460711,618723,158012
43000,96,15775,7,465752,576140,110388
43000,220,15726,8,399361,600058,200697
43000,139,15786,8,457794,684666,226872
43000,249,15735,7,444565,518761,74196
43000,343,15874,8,518981,670446,151465
43000,272,15755,7,429529,509606,80077
43000,181,15738,8,403475,516230,112755
43000,291,15785,7,487863,608073,120210
43000,159,15817,7,477477,751332,273855
43000,433,15833,6,446546,605480,158934
43000,139,15797,7,555534,567617,12083
43000,176,15826,8,469695,702048,232353
43000,424,15873,7,407077,524018,116941
43000,456,15814,8,535145,638650,103505
43000,474,15727,7,530223,569903,39680
43000,130,15832,8,461829,601879,140050
43000,247,15945,7,489497,651978,162481
43000,229,15783,7,459729,504343,44614
43000,308,15797,8,408254,599422,191168
43000,195,15836,7,436676,616660,179984
44000,263,16189,8,473609,599888,126279
44000,135,16242,7,512160,619130,106970
44000,121,16142,7,615153,620294,5141
44000,284,16169,9,482991,618785,135794
44000,221,16200,7,487676,554594,66918
44000,230,16141,7,487557,562820,75263
44000,331,16157,7,426907,612978,186071
44000,310,16092,8,504636,703567,198931
44000,683,16172,7,568283,569335,1052
44000,258,16153,7,423961,607954,183993
44000,456,16040,7,440924,614389,173465
44000,324,16159,7,493058,570032,76974
44000,93,16266,8,500007,747165,247158
44000,159,16172,7,596718,601469,4751
44000,286,16192,7,459842,582987,123145
44000,267,16232,7,467727,557629,89902
44000,74,16044,7,628004,629715,1711
44000,130,16130,6,481141,555922,74781
44000,308,16161,9,499620,671956,172336
44000,288,16091,7,526656,595868,69212
44000,256,16328,7,457216,581564,124348
44000,64,16139,7,492603,680413,187810
44000,259,16130,6,537508,554186,16678
44000,282,16338,7,545261,607527,62266
44000,550,16137,7,524431,557437,33006
44000,269,16137,7,505047,596218,91171
44000,233,16192,8,431352,603265,171913
44000,141,16303,8,402922,582738,179816
44000,328,16246,7,476359,543975,67616
44000,130,16251,8,490256,622625,132369
44000,123,16126,7,546862,599259,52397
44000,228,16211,7,405657,640201,234544
44000,153,16125,7,455470,555003,99533
44000,181,16179,8,513899,521028,7129
44000,265,16245,9,528593,607526,78933
44000,119,16169,7,451598,635175,183577
44000,443,16151,6,533050,561009,27959
44000,163,16221,8,473841,559464,85623
44000,164,16216,8,464156,584661,120505
44000,263,16119,7,469982,574308,104326
44000,476,16309,7,557287,594619,37332
44000,68,16143,8,466878,603863,136985
44000,54,16326,9,502229,534411,32182
44000,250,16099,7,438844,698197,259353
44000,317,16171,7,489031,551310,62279
44000,390,16118,7,464363,585021,120658
44000,175,16182,8,493583,548541,54958
44000,229,16198,7,443696,665180,221484
44000,259,16145,7,643660,685585,41925
44000,184,16210,7,465094,622583,157489
45000,181,16596,7,480062,775907,295845
45000,175,16578,8,563634,649936,86302
45000,388,16510,8,516625,657798,141173
45000,254,16586,7,479236,580695,101459
45000,97,16506,8,419487,655587,236100
45000,273,16526,8,477670,612268,134598
45000,90,16402,8,501169,558348,57179
45000,151,16635,9,443795,605141,161346
45000,227,16453,10,461531,543842,82311
45000,84,16516,7,429292,514936,85644
45000,181,16514,8,425434,615163,189729
45000,375,16578,7,485144,621408,136264
45000,250,16474,7,450365,530756,80391
45000,563,16609,9,575611,628925,53314
45000,441,16516,8,425806,523430,97624
45000,336,16535,7,481615,603865,122250
45000,317,16605,7,477943,603762,125819
45000,488,16448,8,611796,696364,84568
45000,319,16582,7,520398,632362,111964
45000,133,16608,6,406827,591057,184230
45000,49,16549,8,489379,559686,70307
45000,293,16521,8,474249,596689,122440
45000,286,16480,7,426528,637994,211466
45000,187,16468,7,548427,649449,101022
45000,71,16522,8,554063,599665,45602
45000,142,16637,7,445808,745889,300081
45000,607,16432,7,507247,643626,136379
45000,396,16606,7,455342,599515,144173
45000,354,16614,7,574138,744820,170682
45000,460,16525,6,484180,642034,157854
45000,197,16474,8,508674,561775,53101
45000,76,16476,7,414166,681311,267145
45000,139,16591,8,419560,623279,203719
45000,156,16608,7,464757,563975,99218
45000,50,16531,7,434992,630991,195999
45000,127,16626,8,450223,599780,149557
45000,324,16535,7,558829,642063,83234
45000,303,16599,7,423829,574088,150259
45000,184,16648,9,497707,634430,136723
45000,340,16508,8,686365,694639,8274
45000,566,16650,7,520482,565567,45085
45000,495,16619,8,481203,595499,114296
45000,107,16643,8,544158,680431,136273
45000,202,16612,7,439099,612878,173779
45000,131,16597,8,500698,519145,18447
45000,316,16548,7,518872,679468,160596
45000,259,16567,8,496721,635285,138564
45000,635,16520,8,471821,532173,60352
45000,414,16509,7,503085,554250,51165
45000,273,16730,7,473840,587944,114104
46000,296,16876,7,631721,644717,12996
46000,17,16996,8,526485,552023,25538
46000,425,16856,7,464793,546219,81426
46000,373,16878,7,410641,674807,264166
46000,202,16977,8,496487,634594,138107
46000,204,16921,8,507294,652695,145401
46000,300,16715,7,429464,603633,174169
46000,42,16838,7,527730,700536,172806
46000,155,16890,7,500404,606099,105695
46000,404,16845,8,503289,613744,110455
46000,439,16915,9,444952,693415,248463
46000,547,16963,7,720200,744113,23913
46000,248,16996,8,619662,666701,47039
46000,168,16988,8,552176,724176,172000
46000,239,16942,7,763000,819457,56457
46000,242,17043,8,480776,661990,181214
46000,67,17012,8,507188,715125,207937
46000,290,16917,7,570979,808601,237622
46000,438,16856,7,485192,642145,156953
46000,475,17007,7,461041,752845,291804
46000,328,16988,6,580646,660747,80101
46000,116,16763,7,503525,538999,35474
46000,326,16858,9,468284,600866,132582
46000,176,16913,7,646763,843567,196804
46000,67,16908,7,518242,731584,213342
46000,57,16966,8,612229,683074,70845
46000,341,16906,7,616669,659902,43233
46000,284,17018,7,648613,730666,82053
46000,286,17012,7,479580,590416,110836
46000,422,16839,8,660442,715737,55295
46000,337,16906,7,576023,606482,30459
46000,333,16918,6,499667,610817,111150
46000,64,16974,8,524620,563298,38678
46000,220,16891,8,468472,596013,127541
46000,329,16931,7,488847,585578,96731
46000,16,16881,7,479093,567387,88294
46000,245,16883,7,432796,609572,176776
46000,87,17024,8,528844,672630,143786
46000,123,17088,8,478461,595904,117443
46000,135,16970,7,468994,573955,104961
46000,258,16756,8,504619,674314,169695
46000,257,16957,7,480066,653411,173345
46000,330,16895,7,499407,613125,113718
46000,479,16906,8,536857,764042,227185
46000,207,17065,7,568986,631013,62027
46000,116,16898,7,489984,623597,133613
46000,18,16934,6,460405,573759,113354
46000,169,16942,7,621433,807119,185686
46000,248,17029,7,601598,626227,24629
46000,241,17027,8,513737,622812,109075
47000,372,17245,7,491758,671207,179449
47000,236,17307,7,498904,568362,69458
47000,556,17295,7,479543,633902,154359
47000,82,17278,7,500343,684803,184460
47000,198,17296,8,570710,692018,121308
47000,118,17238,7,492391,641912,149521
47000,283,17212,7,526945,604167,77222
47000,116,17187,8,509796,640195,130399
47000,193,17333,7,557721,604400,46679
47000,393,17353,7,462467,590705,128238
47000,304,17369,8,499672,664867,165195
47000,371,17351,9,539254,616759,77505
47000,361,17194,7,536294,573459,37165
47000,421,17254,7,487522,657675,170153
47000,146,17298,8,452827,657178,204351
47000,192,17167,7,598580,657742,59162
47000,362,17196,7,522353,713557,191204
47000,631,17424,7,555344,606164,50820
47000,321,17385,8,545158,632763,87605
47000,546,17393,8,477796,660585,182789
47000,174,17278,7,578649,593917,15268
47000,272,17392,8,610540,757505,146965
47000,182,17201,7,507655,568151,60496
47000,230,17384,8,639910,660688,20778
47000,283,17329,7,587349,635441,48092
47000,330,17270,7,471297,642488,171191
47000,187,17263,7,523744,711830,188086
47000,441,17126,7,457798,562043,104245
47000,115,17402,8,517007,580408,63401
47000,278,17271,8,523075,621625,98550
47000,213,17135,7,520020,698252,178232
47000,266,17242,8,504910,705362,200452
47000,201,17090,7,544798,608548,63750
47000,372,17280,7,481420,605583,124163
47000,275,17300,7,569866,593492,23626
47000,255,17266,7,488261,620062,131801
47000,399,17147,7,537241,677754,140513
47000,160,17422,8,519520,640539,121019
47000,352,17417,7,713099,764205,51106
47000,92,17218,8,480481,591498,111017
47000,218,17337,8,482458,604750,122292
47000,761,17361,8,535984,644498,108514
47000,373,17293,8,483501,668907,185406
47000,179,17304,8,627719,654322,26603
47000,464,17180,7,566060,675709,109649
47000,5,17194,8,550239,638538,88299
47000,257,17293,7,581934,614629,32695
47000,33,17274,7,464465,662708,198243
47000,131,17159,8,520637,607059,86422
47000,326,17353,8,506439,678913,172474
48000,229,17522,7,545020,753669,208649
48000,187,17693,8,483479,657801,174322
48000,291,17730,7,544493,735267,190774
48000,369,17569,8,525406,568458,43052
48000,316,17706,8,491904,654561,162657
48000,197,17590,8,512762,566699,53937
48000,150,17727,7,544065,583046,38981
48000,427,17585,7,541740,738788,197048
48000,160,17751,8,482080,595497,113417
48000,92,17527,7,511393,665765,154372
48000,258,17646,7,557355,621225,63870
48000,293,17535,7,529912,694914,165002
48000,414,17706,7,699294,811752,112458
48000,314,17696,7,520669,649970,129301
48000,330,17605,8,557140,663121,105981
48000,126,17710,7,593266,615689,22423
48000,440,17524,8,495519,672513,176994
48000,455,17569,6,555006,574192,19186
48000,270,17629,8,631632,647701,16069
48000,260,17640,7,625423,717431,92008
48000,380,17716,7,456430,689791,233361
48000,303,17507,7,503198,739688,236490
48000,314,17638,7,524230,641289,117059
48000,486,17722,7,523672,617498,93826
48000,542,17676,7,565374,585393,20019
48000,132,17573,7,521797,640267,118470
48000,134,17666,7,550208,707026,156818
48000,412,17775,7,499069,603012,103943
48000,404,17754,8,532123,882512,350389
48000,252,17662,7,606357,697816,91459
48000,80,17696,8,513206,622723,109517
48000,338,17665,7,546081,735206,189125
48000,251,17680,8,583953,807098,223145
48000,269,17594,7,475813,725348,249535
48000,158,17695,8,507388,729385,221997
48000,616,17561,7,605200,689853,84653
48000,165,17612,7,599520,649339,49819
48000,357,17658,7,476627,816621,339994
48000,782,17498,8,492080,600223,108143
48000,165,17643,9,587812,695494,107682
48000,179,17736,7,665197,790196,124999
48000,409,17719,7,536228,644297,108069
48000,298,17534,8,491326,625053,133727
48000,179,17557,7,546083,634867,88784
48000,123,17598,7,581579,584083,2504
48000,132,17626,7,557649,652355,94706
48000,139,17695,8,556343,594447,38104
48000,553,17802,7,466429,681026,214597
48000,291,17515,7,499719,790885,291166
48000,214,17740,7,449824,763089,313265
49000,289,17975,7,586280,651328,65048
49000,309,17952,7,493169,571549,78380
49000,466,18036,7,520508,592497,71989
49000,304,18035,7,528513,609845,81332
49000,354,17982,7,543728,660607,116879
49000,81,18047,7,865020,865764,744
49000,343,18044,8,534026,638425,104399
49000,139,18092,8,584812,726247,141435
49000,188,18030,10,611621,643169,31548
49000,186,18053,9,585923,615907,29984
49000,336,17913,7,661958,672542,10584
49000,123,18053,7,578107,647650,69543
49000,210,18054,7,612646,657637,44991
49000,86,17952,7,623585,630736,7151
49000,231,18069,7,551761,655713,103952
49000,9,18085,7,651670,782473,130803
49000,569,18015,7,599268,661916,62648
49000,371,18136,8,530604,720785,190181
49000,69,18009,8,563626,689497,125871
49000,357,18113,8,527568,714563,186995
49000,407,18000,7,537639,805352,267713
49000,257,18062,7,508961,721933,212972
49000,577,18080,8,580872,812572,231700
49000,592,18092,8,699925,749913,49988
49000,97,17898,7,526517,667227,140710
49000,186,18173,7,567579,614223,46644
49000,178,17936,7,592326,634706,42380
49000,556,18044,7,502374,698113,195739
49000,278,17982,8,658659,695416,36757
49000,196,18070,7,534869,734441,199572
49000,122,18065,8,587933,641997,54064
49000,198,18039,7,548196,755637,207441
49000,231,17929,7,575805,772522,196717
49000,404,17989,8,784096,793027,8931
49000,361,18182,8,508017,673783,165766
49000,60,17964,7,549423,676563,127140
49000,138,18029,7,622853,688434,65581
49000,81,17963,7,506526,641394,134868
49000,139,18131,8,528167,595435,67268
49000,25,18065,10,549684,732789,183105
49000,62,17987,8,607015,612239,5224
49000,808,17980,7,565227,619020,53793
49000,381,17971,7,542807,561648,18841
49000,460,18051,7,532320,844062,311742
49000,278,17988,7,513273,608616,95343
49000,510,17802,7,460018,679266,219248
49000,207,18100,8,668483,690551,22068
49000,166,18035,9,531007,644186,113179
49000,186,17992,7,500836,599858,99022
49000,121,18037,7,670136,754788,84652
50000,217,18389,7,471120,720488,249368
50000,368,18320,7,775814,822949,47135
50000,464,18336,7,560047,738834,178787
50000,260,18374,9,517967,658000,140033
50000,381,18477,7,561262,671018,109756
50000,294,18338,8,623800,670858,47058
50000,125,18515,7,541081,649547,108466
50000,345,18419,7,587148,639714,52566
50000,201,18370,7,559826,732519,172693
50000,326,18320,8,733417,744836,11419
50000,172,18508,8,499488,616525,117037
50000,318,18445,7,762258,769555,7297
50000,205,18455,8,473948,650081,176133
50000,262,18380,7,493704,622541,128837
50000,171,18393,8,532299,675653,143354
50000,100,18586,7,527869,850600,322731
50000,259,18268,7,613990,659003,45013
50000,213,18357,8,628288,770339,142051
50000,400,18487,7,568579,712404,143825
50000,300,18401,8,597010,725454,128444
50000,268,18430,7,518053,649011,130958
50000,225,18405,7,512541,663805,151264
50000,294,18457,8,543581,632992,89411
50000,443,18300,7,665148,721536,56388
50000,274,18438,8,609066,646591,37525
50000,128,18428,7,512493,666546,154053
50000,252,18353,8,455187,744464,289277
50000,492,18529,8,543363,681949,138586
50000,479,18408,7,586150,681997,95847
50000,186,18441,8,555170,710393,155223
50000,351,18325,7,646479,767109,120630
50000,275,18331,9,566502,681756,115254
50000,359,18448,7,609135,666223,57088
50000,124,18277,8,474421,702122,227701
50000,138,18380,8,636435,660171,23736
50000,431,18360,9,509355,664666,155311
50000,285,18291,7,660595,685846,25251
50000,520,18468,7,486825,632005,145180
50000,278,18297,7,635488,645542,10054
50000,65,18418,7,799771,812348,12577
50000,328,18360,7,564156,694260,130104
50000,227,18468,8,463297,630928,167631
50000,299,18385,7,632525,691101,58576
50000,195,18370,8,540391,954622,414231
50000,297,18462,8,506190,680825,174635
50000,370,18342,8,537138,717965,180827
50000,152,18442,7,596831,700697,103866
50000,389,18374,8,546172,722968,176796
50000,288,18422,7,534545,627210,92665
50000,47,18363,7,519148,646011,126863
51000,183,18678,10,565822,752839,187017
51000,36,18652,8,554966,668582,113616
51000,153,18773,7,541463,666797,125334
51000,210,18787,8,540068,726648,186580
51000,534,18846,8,542788,726753,183965
51000,236,18795,7,725973,762478,36505
51000,456,18752,7,483267,716098,232831
51000,509,18779,8,508640,772128,263488
51000,183,18694,7,572004,642421,70417
51000,322,18840,7,684560,695174,10614
51000,410,18623,7,635896,726853,90957
51000,268,18751,7,580588,651749,71161
51000,294,18659,7,558692,677973,119281
51000,244,18820,8,575046,802041,226995
51000,245,18655,8,566884,662225,95341
51000,419,18782,7,503501,647541,144040
51000,207,18702,8,540479,616083,75604
51000,459,18740,7,486553,723343,236790
51000,333,18849,7,610349,650826,40477
51000,96,18765,7,727648,883333,155685
51000,451,18775,8,524785,656174,131389
51000,129,18758,9,487434,740531,253097
51000,175,18706,7,604646,666710,62064
51000,304,18642,8,644001,750828,106827
51000,175,18683,9,616736,750837,134101
51000,218,18728,8,619733,705819,86086
51000,168,18752,8,576964,754842,177878
51000,284,18813,7,547975,829223,281248
51000,191,18625,7,656501,767236,110735
51000,227,18798,7,559845,670918,111073
51000,104,18768,8,581519,609650,28131
51000,184,18759,8,621932,645163,23231
51000,480,18825,7,602080,635507,33427
51000,157,18869,8,659701,749593,89892
51000,114,18810,7,615678,863427,247749
51000,177,18811,7,604643,672226,67583
51000,498,18714,7,509245,606593,97348
51000,567,18899,8,540023,816290,276267
51000,179,18653,7,583302,639682,56380
51000,266,18628,8,574066,694469,120403
51000,51,18798,7,657784,704118,46334
51000,335,18823,8,567328,726207,158879
51000,341,18700,8,537139,761601,224462
51000,53,18809,7,596686,779987,183301
51000,357,18790,7,651940,740985,89045
51000,478,18769,7,633034,712703,79669
51000,193,18853,7,560624,659198,98574
51000,262,18720,8,493558,679712,186154
51000,93,18819,8,497818,664699,166881
51000,312,18873,7,699975,751784,51809
52000,512,19122,8,521733,727153,205420
52000,278,19141,7,623524,779962,156438
52000,523,19129,7,521946,665932,143986
52000,184,19044,7,534414,816936,282522
52000,355,19007,7,555123,647557,92434
52000,593,19104,8,589721,666611,76890
52000,290,19077,9,565380,759376,193996
52000,244,19116,8,591323,751138,159815
52000,104,19043,8,703127,769530,66403
52000,279,19146,8,508417,855802,347385
52000,218,19186,7,569421,678191,108770
52000,351,19127,8,502693,695139,192446
52000,97,19127,7,599004,663530,64526
52000,108,19208,8,624712,711526,86814
52000,552,19187,7,494452,729867,235415
52000,201,19243,7,569231,764152,194921
52000,258,19020,8,523506,637526,114020
52000,288,19109,7,596965,726841,129876
52000,305,19127,8,538436,639254,100818
52000,359,19176,8,517079,799372,282293
52000,380,19145,7,607914,647112,39198
52000,453,19037,8,586833,663173,76340
52000,168,19176,7,521767,723473,201706
52000,90,19092,7,652702,692878,40176
52000,339,19061,7,841505,842978,1473
52000,470,19165,7,558299,629390,71091
52000,459,19091,8,618985,745639,126654
52000,422,19138,7,564849,689947,125098
52000,343,19090,7,695811,867189,171378
52000,345,19084,7,508948,605141,96193
52000,465,19248,8,543604,693050,149446
52000,396,19066,8,542170,701089,158919
52000,207,19111,7,499574,702161,202587
52000,382,19106,7,557918,733870,175952
52000,232,19133,7,575203,768371,193168
52000,330,19187,8,538414,705446,167032
52000,228,19020,8,761838,861260,99422
52000,183,19185,8,660178,771174,110996
52000,347,19208,8,545041,643262,98221
52000,358,19198,7,506292,682645,176353
52000,253,19109,7,584901,814612,229711
52000,220,19082,8,572446,776490,204044
52000,241,19066,7,510007,657365,147358
52000,220,19193,7,600889,704023,103134
52000,221,19185,7,737654,755133,17479
52000,205,19144,9,549698,681634,131936
52000,283,19037,7,648069,866196,218127
52000,416,19138,7,683479,708980,25501
52000,167,19235,7,573709,692917,119208
52000,406,19079,7,654348,671263,16915
53000,239,19568,7,525087,689756,164669
53000,100,19564,7,510416,900130,389714
53000,532,19463,7,733547,811683,78136
53000,238,19535,7,508129,658118,149989
53000,308,19427,9,652959,701261,48302
53000,134,19502,7,758588,796233,37645
53000,127,19530,7,557392,740055,182663
53000,205,19533,7,657960,785504,127544
53000,299,19403,7,563333,729777,166444
53000,352,19556,7,558113,741832,183719
53000,168,19465,7,640830,740274,99444
53000,267,19492,8,683862,790998,107136
53000,532,19464,7,854331,927745,73414
53000,140,19543,7,544190,655700,111510
53000,582,19478,7,606930,724187,117257
53000,96,19519,7,596444,817748,221304
53000,240,19518,7,579115,708649,129534
53000,246,19533,8,606738,787847,181109
53000,200,19321,7,556889,688985,132096
53000,452,19502,7,514555,775328,260773
53000,429,19321,7,628266,797784,169518
53000,285,19461,8,599228,717568,118340
53000,444,19484,7,544786,977443,432657
53000,231,19461,7,521907,731812,209905
53000,343,19543,7,558865,722857,163992
53000,228,19556,7,584529,702912,118383
53000,294,19566,8,589702,758899,169197
53000,489,19528,7,580517,824038,243521
53000,416,19531,7,527503,725023,197520
53000,439,19480,7,536967,725716,188749
53000,152,19373,7,615925,727714,111789
53000,79,19477,7,540258,708882,168624
53000,243,19366,7,668338,769867,101529
53000,314,19499,7,538021,722976,184955
53000,211,19466,8,689341,758921,69580
53000,220,19470,8,552900,688673,135773
53000,506,19481,7,592716,715313,122597
53000,83,19548,7,719763,789653,69890
53000,285,19575,7,532986,746462,213476
53000,316,19440,8,615408,777263,161855
53000,466,19447,9,603281,677080,73799
53000,403,19484,7,569084,644893,75809
53000,118,19490,7,599294,725619,126325
53000,513,19314,8,484867,702302,217435
53000,330,19570,9,646017,756687,110670
53000,12,19459,7,652044,687795,35751
53000,355,19603,7,582409,800336,217927
53000,200,19487,7,722739,734165,11426
53000,214,19450,7,507644,683942,176298
53000,255,19484,8,621707,771794,150087
54000,367,19894,8,521539,828254,306715
54000,376,19821,7,591695,761839,170144
54000,243,19879,8,568812,728623,159811
54000,288,19958,7,647956,687485,39529
54000,184,19812,8,646216,731631,85415
54000,524,19839,7,678984,722692,43708
54000,170,19780,7,578779,672843,94064
54000,544,19807,8,594839,701031,106192
54000,197,19960,8,743495,771162,27667
54000,219,19868,7,610835,781693,170858
54000,572,19907,8,662690,785476,122786
54000,308,19866,8,577139,712421,135282
54000,325,19863,7,553862,780914,227052
54000,355,19853,7,587345,762723,175378
54000,177,19876,7,705182,736468,31286
54000,46,19873,7,699218,771101,71883
54000,349,19860,7,605906,822028,216122
54000,383,19867,7,552219,672625,120406
54000,392,19894,7,538341,757895,219554
54000,233,19893,7,638642,719568,80926
54000,253,19734,7,572972,757733,184761
54000,246,19945,8,591670,914311,322641
54000,504,19853,7,658037,700052,42015
54000,99,19961,8,581203,692091,110888
54000,227,19890,8,607081,810447,203366
54000,129,19900,8,579075,703801,124726
54000,159,19914,7,619393,694320,74927
54000,437,19997,7,573314,809935,236621
54000,260,19763,8,609242,741360,132118
54000,596,19911,7,560894,875851,314957
54000,333,19876,7,688029,812512,124483
54000,139,19902,7,585528,810638,225110
54000,260,19794,7,649052,696134,47082
54000,188,19738,7,535851,698150,162299
54000,465,19901,7,541677,777273,235596
54000,226,19958,8,614213,680752,66539
54000,470,20000,7,568926,744485,175559
54000,271,19743,9,606121,822500,216379
54000,58,19933,6,808943,1026883,217940
54000,94,19876,8,692900,773977,81077
54000,92,19812,8,604547,798706,194159
54000,202,19959,8,588228,741020,152792
54000,190,19968,8,601293,721679,120386
54000,214,19779,7,650609,723740,73131
54000,319,19870,7,525186,740172,214986
54000,287,19952,8,674440,738650,64210
54000,153,19932,7,637462,704652,67190
54000,183,19867,7,577174,738468,161294
54000,218,19897,8,585053,736523,151470
54000,367,19983,8,632991,690766,57775
55000,524,20145,7,591441,819074,227633
55000,274,20132,9,599425,782264,182839
55000,366,20342,8,821072,822938,1866
55000,297,20092,8,695690,729290,33600
55000,165,20280,8,662221,663272,1051
55000,241,20230,7,570850,703624,132774
55000,189,20096,7,562841,777683,214842
55000,236,20277,7,548577,680591,132014
55000,232,20242,8,640329,812138,171809
55000,332,20350,8,584651,769040,184389
55000,178,20201,7,535293,756141,220848
55000,196,20231,7,635297,798894,163597
55000,321,20378,8,649366,755550,106184
55000,376,20212,8,672163,862343,190180
55000,367,20240,8,576896,708408,131512
55000,295,20355,7,565082,700073,134991
55000,89,20265,7,583529,719717,136188
55000,176,20272,7,669008,827051,158043
55000,762,20220,7,617964,761179,143215
55000,219,20187,7,814377,955707,141330
55000,299,20210,7,616515,777372,160857
55000,48,20243,8,654250,827814,173564
55000,769,20270,7,749609,890198,140589
55000,360,20190,8,655027,770971,115944
55000,218,20196,7,586076,691383,105307
55000,212,20262,8,613086,741731,128645
55000,412,20232,7,553812,848549,294737
55000,109,20180,9,632916,754735,121819
55000,609,20183,8,600787,883226,282439
55000,465,20261,8,561024,903443,342419
55000,663,20282,7,520300,670384,150084
55000,332,20219,7,612019,892813,280794
55000,502,20160,7,651974,850213,198239
55000,449,20388,7,743478,935640,192162
55000,508,20240,8,660335,751538,91203
55000,166,20202,7,611911,813508,201597
55000,201,20215,7,651325,704520,53195
55000,259,20300,8,712110,734800,22690
55000,128,20183,8,643081,777900,134819
55000,334,20224,7,673320,875681,202361
55000,158,20315,7,523888,743978,220090
55000,173,20185,8,643581,830500,186919
55000,60,20287,7,602761,819662,216901
55000,470,20311,8,628703,756081,127378
55000,326,20149,7,629885,732977,103092
55000,212,20171,7,576832,874251,297419
55000,693,20071,7,479236,687442,208206
55000,181,20220,7,648022,730617,82595
55000,187,20411,8,709159,754619,45460
55000,431,20180,7,541907,726122,184215
56000,279,20690,8,606782,737080,130298
56000,123,20491,7,647342,823872,176530
56000,455,20667,7,622330,801312,178982
56000,128,20617,8,620216,689305,69089
56000,191,20672,8,689481,756335,66854
56000,228,20638,8,666839,845709,178870
56000,84,20573,7,731799,865386,133587
56000,369,20534,7,626117,830319,204202
56000,530,20594,7,574100,751664,177564
56000,335,20586,8,552643,734754,182111
56000,122,20679,8,708113,896067,187954
56000,348,20685,8,618295,666095,47800
56000,150,20717,8,620905,764188,143283
56000,88,20504,8,601119,699699,98580
56000,259,20771,9,550122,747619,197497
56000,207,20723,7,560978,800947,239969
56000,419,20577,7,634769,693902,59133
56000,432,20661,8,545865,720941,175076
56000,75,20685,7,651424,772688,121264
56000,37,20500,7,569801,740107,170306
56000,260,20651,7,570403,681574,111171
56000,243,20584,8,574151,930760,356609
56000,698,20535,7,631491,851164,219673
56000,362,20592,7,615222,1011306,396084
56000,412,20759,7,659934,732089,72155
56000,526,20599,8,628103,965734,337631
56000,143,20641,7,608889,689142,80253
56000,346,20547,8,644923,718321,73398
56000,288,20574,8,603407,722551,119144
56000,494,20665,7,599325,780854,181529
56000,19,20525,7,716207,760062,43855
56000,414,20626,9,568318,695439,127121
56000,152,20718,7,584915,819195,234280
56000,210,20592,7,637246,742412,105166
56000,303,20550,8,595918,699657,103739
56000,114,20661,8,635856,765140,129284
56000,433,20646,7,623304,796438,173134
56000,259,20422,7,605949,745686,139737
56000,366,20603,8,550853,837159,286306
56000,394,20719,8,645593,705400,59807
56000,688,20630,7,614138,964454,350316
56000,309,20668,8,620515,705830,85315
56000,410,20604,8,605218,1000250,395032
56000,491,20502,7,628743,859276,230533
56000,316,20622,9,633253,778601,145348
56000,167,20518,7,636702,853771,217069
56000,368,20726,7,533848,741152,207304
56000,152,20691,7,701018,929102,228084
56000,145,20567,7,595479,832433,236954
56000,168,20542,7,556228,853488,297260
57000,192,21001,7,633939,768535,134596
57000,355,20859,8,603688,893471,289783
57000,177,21024,7,660170,843249,183079
57000,447,20965,8,783367,851019,67652
57000,293,21005,7,671299,838450,167151
57000,257,21039,8,838361,881256,42895
57000,522,20956,8,557840,734635,176795
57000,130,20969,7,565851,791284,225433
57000,241,20955,7,656588,846767,190179
57000,475,20947,7,545117,936044,390927
57000,263,21198,10,653239,854178,200939
57000,203,21041,7,675907,788205,112298
57000,68,21014,7,566013,776452,210439
57000,380,21074,7,668083,789663,121580
57000,481,20916,8,815549,860472,44923
57000,364,21121,8,658754,1026203,367449
57000,326,20952,8,718620,869643,151023
57000,610,20894,7,621529,809326,187797
57000,385,20843,8,699014,765107,66093
57000,351,20906,8,577734,752800,175066
57000,455,20970,7,649636,839312,189676
57000,407,20980,8,604980,815415,210435
57000,451,20782,7,624501,833789,209288
57000,473,20787,8,667347,771145,103798
57000,332,20949,8,763326,785761,22435
57000,453,20935,8,650807,938536,287729
57000,164,21020,8,674071,801874,127803
57000,537,21068,7,613214,773497,160283
57000,361,20947,9,612523,831511,218988
57000,794,20947,7,761412,855301,93889
57000,111,21022,7,581135,762975,181840
57000,72,20926,7,597754,714402,116648
57000,494,20993,7,786433,941845,155412
57000,663,20841,7,598574,928690,330116
57000,200,21055,7,586184,774724,188540
57000,438,20841,7,594116,734271,140155
57000,304,21074,7,601851,785824,183973
57000,157,20952,9,641498,926176,284678
57000,292,20999,7,624054,739476,115422
57000,348,21008,7,558980,756243,197263
57000,188,20901,7,567144,883772,316628
57000,447,20748,7,675184,781213,106029
57000,471,20911,7,629520,847484,217964
57000,298,21073,7,861375,890640,29265
57000,161,20944,9,644659,846005,201346
57000,338,20919,7,671164,815809,144645
57000,294,20967,8,778499,846393,67894
57000,348,21066,9,710141,818098,107957
57000,349,20942,7,686471,804431,117960
57000,282,20798,8,643345,806472,163127
58000,283,21384,8,627217,746481,119264
58000,224,21430,7,599975,710207,110232
58000,304,21473,8,717213,834851,117638
58000,353,21399,8,646341,1101564,455223
58000,296,21363,7,664281,763524,99243
58000,178,21447,8,622021,806406,184385
58000,451,21256,7,686646,790111,103465
58000,199,21402,7,591276,867635,276359
58000,670,21284,8,633688,771989,138301
58000,356,21378,7,725970,757103,31133
58000,366,21368,7,725787,761988,36201
58000,334,21380,7,747239,789689,42450
58000,411,21344,8,766318,892568,126250
58000,363,21462,7,724556,792570,68014
58000,157,21367,7,715715,836178,120463
58000,218,21259,7,786254,851588,65334
58000,461,21302,8,734148,787376,53228
58000,582,21252,7,586086,751399,165313
58000,332,21456,8,764691,993947,229256
58000,327,21388,7,585316,797396,212080
58000,42,21306,7,743204,805515,62311
58000,323,21285,8,687859,820832,132973
58000,201,21243,8,812704,959049,146345
58000,280,21345,7,610916,885971,275055
58000,445,21323,7,728349,820067,91718
58000,243,21313,8,646912,893721,246809
58000,744,21336,8,722376,828052,105676
58000,281,21331,8,599835,799767,199932
58000,181,21298,8,681364,733272,51908
58000,48,21434,7,680446,796986,116540
58000,554,21283,7,733177,764646,31469
58000,339,21346,8,685174,832085,146911
58000,391,21435,8,679028,742930,63902
58000,249,21421,7,722982,793223,70241
58000,151,21353,7,637866,862455,224589
58000,745,21339,7,689220,865928,176708
58000,67,21326,9,545968,826179,280211
58000,148,21414,7,728981,731305,2324
58000,158,21291,7,719475,814648,95173
58000,121,21286,8,630922,819167,188245
58000,506,21328,9,622896,843989,221093
58000,459,21414,7,648309,942133,293824
58000,907,21403,8,629169,710565,81396
58000,227,21390,9,692148,824628,132480
58000,148,21289,7,672295,776169,103874
58000,115,21352,8,656120,801401,145281
58000,58,21296,8,663036,989090,326054
58000,577,21299,8,690891,835022,144131
58000,129,21397,8,717748,791406,73658
58000,358,21271,8,592038,860581,268543
59000,90,21653,7,818321,827056,8735
59000,602,21782,8,766119,803641,37522
59000,217,21713,7,557164,794892,237728
59000,606,21611,8,622093,821727,199634
59000,405,21825,7,653373,810560,157187
59000,220,21739,10,780793,861532,80739
59000,250,21729,8,625350,910337,284987
59000,338,21704,7,947486,1045853,98367
59000,228,21670,8,924123,931213,7090
59000,217,21689,8,579870,782396,202526
59000,68,21722,8,720912,829566,108654
59000,673,21619,8,622139,741145,119006
59000,151,21667,7,648118,719610,71492
59000,233,21711,9,920723,1012352,91629
59000,132,21784,7,608022,891632,283610
59000,252,21637,7,625367,842016,216649
59000,387,21662,7,857697,870502,12805
59000,232,21740,7,755195,866646,111451
59000,626,21765,7,680131,765082,84951
59000,471,21572,8,575329,771238,195909
59000,107,21751,8,770570,796556,25986
59000,334,21705,8,695788,887502,191714
59000,233,21698,7,795147,967018,171871
59000,478,21743,7,829173,863181,34008
59000,363,21647,7,700696,813621,112925
59000,513,21771,7,645656,772513,126857
59000,223,21655,7,696193,806024,109831
59000,426,21787,7,742963,776570,33607
59000,395,21660,7,609796,772928,163132
59000,244,21641,7,641197,779896,138699
59000,212,21647,7,547605,770106,222501
59000,270,21572,7,699313,801252,101939
59000,620,21617,8,625278,865197,239919
59000,436,21734,7,657460,691748,34288
59000,183,21771,7,645395,820860,175465
59000,496,21665,7,616098,932370,316272
59000,283,21673,7,773368,946587,173219
59000,301,21721,8,600396,782616,182220
59000,251,21670,7,611501,709383,97882
59000,195,21668,7,630022,830173,200151
59000,373,21786,7,768027,925854,157827
59000,179,21623,7,583145,807328,224183
59000,447,21723,7,575118,876780,301662
59000,491,21685,7,644943,848008,203065
59000,316,21777,8,698230,795427,97197
59000,320,21681,9,684660,911991,227331
59000,450,21731,7,645519,1037793,392274
59000,616,21733,8,657946,988520,330574
59000,349,21671,7,653750,984788,331038
59000,386,21720,8,820993,1190227,369234
60000,211,22063,8,676082,791506,115424
60000,700,22095,7,620843,938429,317586
60000,202,22128,8,603929,784789,180860
60000,721,22046,7,700859,751176,50317
60000,179,21948,8,633097,843772,210675
60000,522,22094,8,640428,1002523,362095
60000,480,22075,7,690232,892568,202336
60000,738,22057,7,660985,803606,142621
60000,351,22127,8,609423,946357,336934
60000,309,22165,8,722928,878896,155968
60000,494,21939,8,666295,943322,277027
60000,462,22058,8,992628,1032371,39743
60000,246,22050,8,624855,763072,138217
60000,28,22083,8,647644,790499,142855
60000,172,22090,8,895921,897681,1760
60000,448,22086,8,737742,807281,69539
60000,267,22098,7,666416,790602,124186
60000,362,22139,8,629830,790945,161115
60000,158,22112,7,874374,915625,41251
60000,220,21997,7,547880,737449,189569
60000,111,22033,8,727397,817865,90468
60000,732,22041,7,733627,890810,157183
60000,82,22179,7,671412,887959,216547
60000,319,22143,7,690967,825287,134320
60000,380,22103,8,654081,838912,184831
60000,356,22082,6,671827,700575,28748
60000,273,22179,7,584740,926545,341805
60000,415,22131,7,923512,954922,31410
60000,312,21943,8,758217,1001465,243248
60000,605,22112,7,734500,825529,91029
60000,119,21986,10,719679,821249,101570
60000,458,22012,7,703512,855134,151622
60000,465,22193,7,699275,854994,155719
60000,322,22039,7,685202,1100547,415345
60000,512,22001,8,607489,843380,235891
60000,271,22056,7,662087,959381,297294
60000,428,22025,7,712627,858356,145729
60000,270,22147,7,601592,753191,151599
60000,432,22103,7,662612,819187,156575
60000,68,22017,8,759231,828490,69259
60000,140,22168,7,707930,858705,150775
60000,60,21965,8,688682,911118,222436
60000,302,22027,8,630237,895562,265325
60000,314,22183,8,702549,795544,92995
60000,382,22124,7,582572,812427,229855
60000,401,22020,8,691173,844326,153153
60000,341,22043,7,671496,915677,244181
60000,396,22206,8,795762,937135,141373
60000,446,22207,7,732002,938592,206590
60000,443,22194,7,707743,873180,165437
61000,897,22480,8,709362,842892,133530
61000,208,22486,8,662483,936374,273891
61000,280,22379,7,817832,850595,32763
61000,425,22415,7,694619,1033764,339145
61000,625,22456,8,623590,867088,243498
61000,215,22326,8,649522,1007258,357736
61000,556,22448,7,789875,828715,38840
61000,310,22540,7,779158,843376,64218
61000,600,22379,8,700115,840816,140701
61000,173,22524,7,695923,843405,147482
61000,12,22342,8,721238,797982,76744
61000,280,22339,8,710122,1057636,347514
61000,616,22458,7,581465,767822,186357
61000,118,22372,7,856758,890011,33253
61000,183,22557,7,601762,801584,199822
61000,175,22425,8,749782,834802,85020
61000,575,22474,8,784332,910273,125941
61000,362,22532,8,734544,804779,70235
61000,279,22620,8,723952,868589,144637
61000,220,22313,7,813121,839364,26243
61000,125,22427,7,752032,808266,56234
61000,116,22393,7,658621,817457,158836
61000,382,22469,9,644208,873918,229710
61000,77,22506,8,598649,910623,311974
61000,642,22320,7,759257,945673,186416
61000,150,22369,9,657018,882129,225111
61000,341,22390,8,692119,863280,171161
61000,43,22486,7,655640,775934,120294
61000,223,22486,8,652024,908854,256830
61000,323,22452,7,706647,870187,163540
61000,254,22486,7,592355,848942,256587
61000,143,22273,9,705032,1079440,374408
61000,284,22462,7,779553,893708,114155
61000,312,22373,8,672590,825530,152940
61000,489,22433,7,787286,809650,22364
61000,398,22403,7,689406,890566,201160
61000,354,22427,8,705712,929001,223289
61000,296,22412,7,657346,766689,109343
61000,96,22460,7,657989,802040,144051
61000,466,22541,8,693057,877646,184589
61000,59,22448,7,651093,851633,200540
61000,64,22428,7,697949,844849,146900
61000,340,22486,7,760272,856359,96087
61000,449,22397,9,683894,762303,78409
61000,176,22299,9,667059,829764,162705
61000,366,22538,8,820997,1080340,259343
61000,657,22506,7,841618,920673,79055
61000,362,22473,7,785721,794629,8908
61000,178,22570,9,640410,858574,218164
61000,467,22485,7,652908,801832,148924
62000,436,22819,7,670041,870152,200111
62000,164,22857,7,715968,818684,102716
62000,234,22934,8,652120,846775,194655
62000,334,22846,8,631557,828335,196778
62000,457,22676,8,742079,813016,70937
62000,264,22955,7,712249,958261,246012
62000,362,22709,8,721296,902352,181056
62000,503,22814,8,648534,900486,251952
62000,185,22761,8,722306,871468,149162
62000,162,22811,8,690614,863052,172438
62000,219,22824,8,648298,805902,157604
62000,337,22819,8,727605,791502,63897
62000,496,22783,7,702565,992477,289912
62000,322,22876,7,663851,838413,174562
62000,140,22832,7,621738,995196,373458
62000,375,22892,8,763489,788906,25417
62000,307,22723,7,741558,806413,64855
62000,445,22810,8,581606,902925,321319
62000,258,22698,8,791158,862125,70967
62000,284,22870,8,736377,967273,230896
62000,366,22768,7,805997,890392,84395
62000,549,22868,7,633172,866123,232951
62000,248,22817,7,768659,896430,127771
62000,179,22774,7,834939,876869,41930
62000,322,22928,7,724387,875106,150719
62000,118,22744,7,575301,799191,223890
62000,301,22887,7,750072,888514,138442
62000,342,22744,8,768958,838743,69785
62000,729,22828,8,738418,849681,111263
62000,187,22737,7,713252,894732,181480
62000,441,22785,6,680578,923910,243332
62000,396,22810,7,837532,930046,92514
62000,151,22700,8,656656,827201,170545
62000,667,22778,8,771700,949052,177352
62000,9,22764,8,619967,1005571,385604
62000,499,22755,7,653445,903690,250245
62000,90,22795,7,674365,866605,192240
62000,374,22806,7,676960,939089,262129
62000,321,22918,9,662039,1083476,421437
62000,344,22852,7,711538,891793,180255
62000,253,22775,7,706317,796246,89929
62000,390,22721,7,752685,930393,177708
62000,594,22759,7,741342,904818,163476
62000,801,22836,7,675998,900137,224139
62000,652,22999,8,750381,830297,79916
62000,483,22763,7,775907,1118272,342365
62000,116,22790,7,690860,811667,120807
62000,452,22823,8,1066712,1117629,50917
62000,327,22836,7,560364,811273,250909
62000,58,22695,7,738260,818468,80208
63000,108,23160,8,687887,1062559,374672
63000,278,23126,8,660944,905098,244154
63000,239,23293,7,789303,962398,173095
63000,530,23100,8,729697,833141,103444
63000,94,23203,8,600247,784411,184164
63000,282,23097,7,755174,845456,90282
63000,265,23193,8,661877,865625,203748
63000,258,23199,8,727449,848146,120697
63000,87,23272,8,701513,814488,112975
63000,480,23299,7,697500,996557,299057
63000,393,23227,7,702697,1139231,436534
63000,101,23280,8,655920,796418,140498
63000,466,23007,8,781813,874043,92230
63000,90,23097,8,681263,821068,139805
63000,279,23194,7,777675,870059,92384
63000,188,23231,8,803647,830644,26997
63000,269,23130,8,742992,880658,137666
63000,277,23199,7,823608,927959,104351
63000,250,23105,7,654847,960626,305779
63000,272,23214,8,697327,877957,180630
63000,560,23328,7,682969,859347,176378
63000,345,23285,7,753190,862929,109739
63000,41,23194,8,702828,855405,152577
63000,142,23024,7,682877,827705,144828
63000,104,23129,8,728243,876363,148120
63000,271,23217,9,754463,873254,118791
63000,702,23117,7,650058,842556,192498
63000,314,23034,7,669272,843433,174161
63000,552,23202,8,681319,870617,189298
63000,153,23232,7,769706,962135,192429
63000,289,23175,7,945987,952450,6463
63000,370,23130,7,722776,848420,125644
63000,201,23014,8,750830,871309,120479
63000,308,23330,8,703250,887022,183772
63000,77,23319,8,709271,806299,97028
63000,492,23185,7,630742,887162,256420
63000,142,23082,7,788792,1128181,339389
63000,421,23148,8,690439,899643,209204
63000,535,23124,7,780822,890399,109577
63000,537,23107,7,639759,784151,144392
63000,154,23350,7,704879,971967,267088
63000,140,23318,7,682358,849259,166901
63000,384,23136,8,745534,866166,120632
63000,136,23143,7,745659,825663,80004
63000,268,23195,7,715198,915192,199994
63000,248,22926,7,741311,950344,209033
63000,298,23335,7,753210,840427,87217
63000,153,23024,7,712476,883718,171242
63000,137,23214,8,843051,866352,23301
63000,627,23033,8,869309,985509,116200
64000,293,23504,8,735319,1142918,407599
64000,224,23474,7,752948,899718,146770
64000,347,23586,8,718422,941756,223334
64000,140,23525,7,709382,839448,130066
64000,112,23561,8,722152,895220,173068
64000,382,23526,8,703410,1010880,307470
64000,176,23437,8,705805,843003,137198
64000,194,23675,8,695529,932818,237289
64000,319,23505,7,795590,1071908,276318
64000,583,23550,8,712206,905344,193138
64000,282,23598,7,767305,944844,177539
64000,133,23456,7,722634,905546,182912
64000,412,23446,8,877930,907542,29612
64000,150,23579,8,883138,962060,78922
64000,679,23643,9,688786,1042392,353606
64000,50,23325,8,731218,911859,180641
64000,76,23492,8,900302,1003432,103130
64000,497,23550,8,773625,846940,73315
64000,267,23579,8,664500,789414,124914
64000,728,23460,8,815590,873930,58340
64000,78,23513,7,715820,820910,105090
64000,297,23420,7,764354,877509,113155
64000,595,23536,7,730465,805773,75308
64000,194,23546,9,751459,839107,87648
64000,656,23604,7,852643,1057690,205047
64000,233,23645,8,785975,857101,71126
64000,17,23761,7,708335,860546,152211
64000,295,23580,8,664009,882967,218958
64000,456,23525,7,717970,901018,183048
64000,223,23681,7,607076,851743,244667
64000,168,23457,8,777725,855391,77666
64000,196,23513,7,699759,946640,246881
64000,86,23387,8,732247,988104,255857
64000,164,23545,8,1020159,1166556,146397
64000,768,23546,7,665999,921654,255655
64000,50,23713,8,715611,829852,114241
64000,512,23549,7,676248,899049,222801
64000,166,23458,7,646939,980998,334059
64000,464,23380,7,784925,955943,171018
64000,423,23474,7,763083,958383,195300
64000,438,23423,7,754070,785345,31275
64000,325,23440,8,763042,990562,227520
64000,321,23399,9,806817,877232,70415
64000,447,23529,7,724041,870948,146907
64000,167,23606,7,775617,865814,90197
64000,468,23492,7,670796,802262,131466
64000,349,23461,8,807510,881093,73583
64000,121,23577,7,654833,921487,266654
64000,382,23621,8,867091,1056344,189253
64000,164,23540,8,695092,916099,221007
65000,19,23870,7,688446,872081,183635
65000,281,24022,8,673437,1159854,486417
65000,517,23903,7,894322,909586,15264
65000,169,23938,7,699914,884838,184924
65000,400,24109,8,792084,825462,33378
65000,282,23865,7,686566,786459,99893
65000,382,23827,8,844185,901273,57088
65000,355,23863,8,1027665,1095276,67611
65000,196,23928,8,742782,860922,118140
65000,380,24030,9,685936,942948,257012
65000,377,23928,7,782678,915874,133196
65000,306,23774,7,689584,863543,173959
65000,381,23773,8,671806,815192,143386
65000,247,23888,8,760169,908797,148628
65000,286,23951,8,912222,932921,20699
65000,455,24011,7,667939,864658,196719
65000,82,23913,8,812580,983760,171180
65000,372,24028,8,822265,839329,17064
65000,362,23955,7,807789,1161089,353300
65000,220,23827,7,752938,956355,203417
65000,238,23910,8,708484,926281,217797
65000,172,23845,7,788609,873851,85242
65000,460,23853,7,765009,865038,100029
65000,606,23887,8,662435,769683,107248
65000,276,23770,7,664123,883274,219151
65000,502,23881,7,780725,905612,124887
65000,538,23969,8,755231,978138,222907
65000,114,23803,8,819235,1039259,220024
65000,53,23984,8,746619,865389,118770
65000,415,23911,7,754475,905492,151017
65000,192,23887,7,685306,877318,192012
65000,393,23966,7,688187,1014032,325845
65000,71,24020,7,684874,1004196,319322
65000,290,23932,7,918167,1170912,252745
65000,144,24017,8,719162,826023,106861
65000,256,23810,8,684871,967080,282209
65000,367,23939,7,807037,869081,62044
65000,514,23841,7,660621,954406,293785
65000,251,23956,7,675902,920615,244713
65000,333,23744,7,814185,967108,152923
65000,150,23942,8,886956,919794,32838
65000,301,23926,8,790195,821036,30841
65000,286,23895,7,621110,834987,213877
65000,179,23984,8,801855,1002499,200644
65000,246,23757,8,735926,921178,185252
65000,163,23879,7,723804,870817,147013
65000,407,23842,7,720391,818078,97687
65000,392,23853,8,861654,960202,98548
65000,508,23731,7,747074,1121332,374258
65000,417,23870,8,682423,1241828,559405
66000,141,24328,7,692061,852748,160687
66000,299,24204,9,741231,928758,187527
66000,572,24304,8,713441,935187,221746
66000,138,24207,8,825525,1007958,182433
66000,175,24240,7,798439,853138,54699
66000,278,24271,8,729717,964648,234931
66000,105,24172,7,723008,948444,225436
66000,170,24334,7,698638,841029,142391
66000,188,24261,8,858037,919590,61553
66000,129,24322,8,704571,883886,179315
66000,392,24227,7,765128,872593,107465
66000,240,24232,7,780170,987028,206858
66000,144,24394,7,728511,913147,184636
66000,166,24262,7,682762,1042528,359766
66000,173,24352,7,803033,938006,134973
66000,165,24229,7,595282,876641,281359
66000,440,24356,7,689754,933143,243389
66000,535,24353,8,778163,1039130,260967
66000,268,24271,7,763874,1012573,248699
66000,482,24301,8,735193,941392,206199
66000,222,24387,7,842466,902624,60158
66000,84,24315,7,803901,1030213,226312
66000,199,24162,9,982804,988706,5902
66000,94,24104,9,716716,902619,185903
66000,330,24279,8,873963,1115952,241989
66000,523,24258,8,780013,948879,168866
66000,80,24290,9,686288,862680,176392
66000,484,24330,8,710970,973105,262135
66000,223,24276,7,702037,962917,260880
66000,442,24238,8,750012,945704,195692
66000,250,24239,8,778625,1007191,228566
66000,296,24284,7,817008,914279,97271
66000,485,24184,8,707600,910462,202862
66000,204,24262,7,725470,898115,172645
66000,515,24370,7,878117,1002802,124685
66000,173,24433,8,780768,1103816,323048
66000,377,24154,7,742869,816208,73339
66000,371,24276,7,719171,858246,139075
66000,51,24240,7,795610,858464,62854
66000,149,24314,8,814215,969134,154919
66000,519,24344,8,734583,955689,221106
66000,237,24211,9,762720,990474,227754
66000,150,24153,8,735345,946167,210822
66000,503,24455,7,673494,992684,319190
66000,581,24289,7,764040,828271,64231
66000,136,24098,9,821240,1007948,186708
66000,213,24396,8,757960,1010245,252285
66000,10,24307,7,773692,1092170,318478
66000,504,24170,8,755159,877138,121979
66000,374,24124,8,748779,901691,152912
67000,484,24630,7,730249,994152,263903
67000,155,24646,7,650803,923156,272353
67000,180,24607,7,751583,993359,241776
67000,73,24591,8,915048,989529,74481
67000,251,24656,8,828724,900911,72187
67000,531,24641,8,686734,994851,308117
67000,434,24603,7,744640,940587,195947
67000,476,24667,7,834410,860744,26334
67000,242,24588,7,760297,926898,166601
67000,353,24631,8,695368,1040506,345138
67000,411,24692,8,743698,934253,190555
67000,406,24585,8,850001,935443,85442
67000,134,24646,8,944307,960694,16387
67000,187,24602,7,738415,1002272,263857
67000,662,24718,7,878221,883337,5116
67000,542,24667,7,778307,1009415,231108
67000,303,24704,8,730952,1149372,418420
67000,366,24624,8,798258,1090359,292101
67000,291,24795,7,778575,1055496,276921
67000,384,24656,8,1003387,1073587,70200
67000,260,24633,7,767693,983252,215559
67000,49,24713,7,846058,925253,79195
67000,358,24614,7,782002,967029,185027
67000,76,24833,7,806053,960252,154199
67000,421,24537,8,789881,1005503,215622
67000,213,24599,7,802499,956431,153932
67000,125,24686,8,696690,938739,242049
67000,512,24438,7,744868,936964,192096
67000,245,24685,8,823863,1250004,426141
67000,330,24602,8,717317,957208,239891
67000,404,24565,7,1050902,1062964,12062
67000,266,24706,7,734820,904583,169763
67000,277,24627,8,835287,881036,45749
67000,570,24620,7,1113985,1213564,99579
67000,566,24643,9,662939,899466,236527
67000,401,24733,8,728762,999333,270571
67000,164,24659,8,729086,918357,189271
67000,394,24519,8,826211,1008509,182298
67000,405,24612,8,710721,949769,239048
67000,344,24802,7,733065,910739,177674
67000,152,24683,8,860610,1009017,148407
67000,242,24637,8,763139,890400,127261
67000,315,24619,9,701871,963992,262121
67000,372,24451,8,765992,1069434,303442
67000,470,24662,8,771017,957940,186923
67000,250,24774,7,724752,937874,213122
67000,318,24590,7,682620,796102,113482
67000,424,24495,8,787424,1172638,385214
67000,489,24746,8,1091119,1135104,43985
67000,146,24489,9,746092,801583,55491
68000,320,24968,8,834552,896068,61516
68000,751,24888,8,930733,1060747,130014
68000,58,24963,8,777628,946136,168508
68000,51,24967,7,723722,835444,111722
68000,368,24788,8,721598,986059,264461
68000,487,25145,7,827128,1266267,439139
68000,607,25064,9,796623,969507,172884
68000,470,24983,9,723068,993517,270449
68000,353,24943,8,778436,916906,138470
68000,199,25091,8,702540,1027971,325431
68000,692,24883,8,1076823,1186338,109515
68000,563,24864,9,1313354,1558080,244726
68000,469,25056,9,834086,1069450,235364
68000,119,25150,8,674334,944721,270387
68000,433,25006,7,709127,865817,156690
68000,301,25057,7,720128,941409,221281
68000,328,25079,8,825914,940863,114949
68000,222,24843,7,743869,1024590,280721
68000,216,25038,8,734771,937853,203082
68000,134,25036,7,694820,1027965,333145
68000,542,24919,7,777188,1239155,461967
68000,287,25093,8,687512,987996,300484
68000,450,25076,8,1112013,1224364,112351
68000,92,24935,8,698481,963255,264774
68000,324,25095,8,705980,999558,293578
68000,322,25083,7,705354,833487,128133
68000,106,24956,7,841693,942040,100347
68000,150,25172,8,896901,999072,102171
68000,278,25008,8,737982,1097309,359327
68000,287,24912,8,754472,997218,242746
68000,308,24778,8,810542,947886,137344
68000,465,24936,8,761951,1323680,561729
68000,82,24947,8,795933,1003673,207740
68000,317,25035,7,757671,972047,214376
68000,291,25103,8,796486,971240,174754
68000,203,24904,7,836876,996966,160090
68000,336,25048,7,830777,876857,46080
68000,412,25058,7,688079,924353,236274
68000,469,24925,8,751620,913530,161910
68000,484,25106,7,729251,979980,250729
68000,289,24969,7,753621,948518,194897
68000,227,25134,8,794336,967175,172839
68000,332,25027,7,710303,904623,194320
68000,685,24962,7,775751,983229,207478
68000,132,24989,8,769322,953376,184054
68000,429,24832,7,643890,1064369,420479
68000,136,25101,8,759878,983824,223946
68000,192,24941,8,764091,853928,89837
68000,339,25084,8,755910,1066030,310120
68000,480,25082,8,993066,1094368,101302
69000,167,25460,7,861463,966966,105503
69000,243,25448,8,695656,891809,196153
69000,289,25491,7,816815,1205713,388898
69000,220,25264,8,826795,933438,106643
69000,403,25382,8,740719,908363,167644
69000,403,25379,7,869279,1142605,273326
69000,234,25318,7,696992,901156,204164
69000,435,25341,8,942688,1060404,117716
69000,158,25348,8,735105,1020873,285768
69000,135,25290,7,691818,1172381,480563
69000,309,25250,7,905217,951371,46154
69000,332,25407,7,785993,905933,119940
69000,427,25536,9,800515,1195236,394721
69000,382,25421,7,787393,1005773,218380
69000,352,25401,8,659729,955285,295556
69000,168,25368,8,772310,950406,178096
69000,197,25352,9,809841,969695,159854
69000,404,25310,7,894297,1187248,292951
69000,565,25408,7,711997,1038407,326410
69000,130,25326,8,815893,924304,108411
69000,162,25411,8,1016570,1138688,122118
69000,628,25487,7,725069,956159,231090
69000,272,25427,8,767304,1074438,307134
69000,514,25528,8,796405,1098286,301881
69000,547,25305,8,914203,1057773,143570
69000,637,25399,7,881979,918566,36587
69000,590,25505,7,789708,982580,192872
69000,495,25315,8,847817,955209,107392
69000,542,25314,7,708590,989805,281215
69000,62,25313,8,714307,915976,201669
69000,107,25426,7,767668,987463,219795
69000,893,25254,8,712342,964673,252331
69000,832,25351,7,864552,979567,115015
69000,287,25575,8,934817,1382136,447319
69000,187,25379,8,697001,992571,295570
69000,53,25372,8,832593,966425,133832
69000,276,25477,7,839106,931714,92608
69000,213,25362,7,722787,953679,230892
69000,249,25344,8,771073,919798,148725
69000,54,25353,8,775849,904934,129085
69000,252,25435,8,753412,1063771,310359
69000,363,25498,8,1243364,1408786,165422
69000,77,25322,7,719763,915067,195304
69000,224,25297,8,762068,880503,118435
69000,625,25483,8,782944,939348,156404
69000,250,25523,8,821429,1014645,193216
69000,223,25311,7,697645,1005034,307389
69000,275,25384,7,695438,955198,259760
69000,250,25251,8,817495,926468,108973
69000,400,25489,8,760120,969902,209782
70000,340,25671,7,838016,1043146,205130
70000,131,25695,7,729644,1043400,313756
70000,78,25804,8,902414,1115623,213209
70000,78,25689,7,849338,1076793,227455
70000,565,25664,8,740572,963517,222945
70000,225,25782,7,911348,1111177,199829
70000,166,25637,7,809383,932568,123185
70000,224,25776,8,743706,915033,171327
70000,347,25739,7,857415,1026379,168964
70000,223,25753,8,774345,926818,152473
70000,521,25821,7,790635,961259,170624
70000,225,25696,8,850870,1038830,187960
70000,216,25589,7,865596,989884,124288
70000,113,25729,8,726574,934504,207930
70000,425,25829,8,805719,933580,127861
70000,487,25842,9,787027,955372,168345
70000,440,25841,7,823362,1305584,482222
70000,144,25643,7,835553,935512,99959
70000,526,25764,8,725562,962341,236779
70000,397,25837,8,780891,1116642,335751
70000,220,25875,8,824842,1145431,320589
70000,255,25690,7,911429,974805,63376
70000,411,25798,7,973457,1001675,28218
70000,681,25720,7,834984,1011271,176287
70000,417,25884,8,893703,1030048,136345
70000,529,25744,9,820816,1003681,182865
70000,692,25819,7,912144,990486,78342
70000,297,25730,9,1082052,1098568,16516
70000,68,25826,7,900807,964050,63243
70000,291,25537,9,707407,963122,255715
70000,127,25895,7,913750,1023915,110165
70000,104,25673,8,817340,987189,169849
70000,146,25812,8,879305,1098406,219101
70000,45,25692,8,776143,1130706,354563
70000,245,25751,8,872136,995388,123252
70000,804,25739,7,890529,976071,85542
70000,265,25768,7,910910,945671,34761
70000,267,25662,8,915780,1024237,108457
70000,230,25699,8,837575,983262,145687
70000,134,25819,8,774575,1046126,271551
70000,503,25836,7,826777,1211302,384525
70000,140,25692,8,659556,1034952,375396
70000,323,25824,8,761878,1089405,327527
70000,406,25734,10,775153,950581,175428
70000,220,25717,7,836633,1035078,198445
70000,409,25758,8,734580,1110744,376164
70000,485,25781,8,757304,831130,73826
70000,427,25705,8,699384,1019899,320515
70000,358,25829,7,739664,985134,245470
70000,399,25748,7,681499,938302,256803
71000,612,26132,7,823848,995162,171314
71000,482,26209,7,756569,990219,233650
71000,148,26230,7,730867,924962,194095
71000,711,26228,7,981640,1091458,109818
71000,143,26029,7,798175,943676,145501
71000,587,26160,8,1027556,1051763,24207
71000,108,26136,8,824585,1004576,179991
71000,524,26186,8,863301,932199,68898
71000,244,26173,7,966195,969276,3081
71000,230,26169,8,677859,905839,227980
71000,119,25945,7,733885,926268,192383
71000,164,26158,7,676419,1200265,523846
71000,220,26164,7,776032,962880,186848
71000,184,26022,7,831999,1043892,211893
71000,335,26135,9,828171,917025,88854
71000,211,26037,8,725405,867680,142275
71000,76,26102,9,891970,1109959,217989
71000,263,26064,8,774548,1104668,330120
71000,260,26168,7,968661,1113507,144846
71000,389,26052,8,973402,988391,14989
71000,420,26081,8,857154,996078,138924
71000,399,25990,8,814372,986938,172566
71000,234,25972,7,765093,959690,194597
71000,243,26099,8,743811,851608,107797
71000,117,26182,8,755768,1042352,286584
71000,357,26199,7,932718,1052316,119598
71000,388,26111,7,762417,1014798,252381
71000,104,26077,8,821869,1151993,330124
71000,233,26214,7,782142,900846,118704
71000,530,26039,7,832757,920465,87708
71000,345,26138,8,838231,932918,94687
71000,614,26007,8,862910,959542,96632
71000,653,26235,7,928782,1030410,101628
71000,500,26164,8,856506,1073029,216523
71000,279,26121,8,804101,947529,143428
71000,403,26319,7,837907,951432,113525
71000,555,26182,7,806865,904822,97957
71000,436,26199,8,906872,1011273,104401
71000,254,26292,8,717897,1075575,357678
71000,511,26265,7,855379,998296,142917
71000,321,26357,8,867801,1093676,225875
71000,320,25946,8,872132,1030249,158117
71000,475,26161,8,779058,1107116,328058
71000,119,26211,8,918533,1124068,205535
71000,379,26095,7,964615,1207188,242573
71000,71,25983,7,758713,1048545,289832
71000,353,26041,9,752021,861409,109388
71000,357,26079,8,831762,883950,52188
71000,215,26235,7,764758,1020245,255487
71000,235,26125,7,781280,1086302,305022
72000,42,26553,8,812065,962582,150517
72000,359,26456,7,893320,1283431,390111
72000,478,26494,8,1060583,1223449,162866
72000,470,26422,6,905278,1154196,248918
72000,369,26317,7,766788,1043228,276440
72000,196,26475,7,946006,1145345,199339
72000,538,26494,7,771253,1054129,282876
72000,380,26445,8,803060,1041641,238581
72000,653,26520,7,830645,1062859,232214
72000,159,26488,7,989177,1279541,290364
72000,503,26490,7,825455,1357391,531936
72000,152,26558,7,1226517,1330268,103751
72000,556,26412,8,738682,1097559,358877
72000,423,26675,8,774674,915424,140750
72000,254,26417,8,914182,924142,9960
72000,256,26467,7,790758,1235560,444802
72000,267,26525,9,856235,1068260,212025
72000,187,26555,9,883060,1009581,126521
72000,394,26644,7,1109744,1171799,62055
72000,256,26551,8,811596,981045,169449
72000,358,26460,7,739294,1001580,262286
72000,76,26433,7,1024541,1074802,50261
72000,582,26319,7,802296,1026963,224667
72000,363,26456,7,962769,1017491,54722
72000,720,26556,8,798298,1071854,273556
72000,246,26482,9,961897,1183124,221227
72000,281,26436,8,997446,1039967,42521
72000,257,26356,7,883861,1074544,190683
72000,600,26567,7,780557,1147661,367104
72000,252,26502,8,1015452,1041931,26479
72000,220,26580,7,798996,925629,126633
72000,542,26518,8,908268,1162100,253832
72000,209,26555,7,947488,1023368,75880
72000,112,26393,7,841738,958410,116672
72000,258,26367,7,902520,1103968,201448
72000,525,26586,8,889926,999656,109730
72000,310,26526,7,765305,1032443,267138
72000,54,26524,7,1031893,1220022,188129
72000,488,26450,7,916825,1370806,453981
72000,367,26452,9,913221,941166,27945
72000,354,26535,7,922435,974120,51685
72000,239,26596,7,779706,879921,100215
72000,384,26337,7,681867,897752,215885
72000,136,26479,8,807855,955633,147778
72000,559,26418,8,829294,918755,89461
72000,173,26465,8,734027,961676,227649
72000,311,26465,7,863605,915193,51588
72000,559,26466,7,781907,1085553,303646
72000,86,26501,7,857376,969217,111841
72000,738,26467,7,784353,889244,104891
73000,127,26769,7,1130342,1261847,131505
73000,242,26822,8,893889,976020,82131
73000,219,26887,8,1142291,1248354,106063
73000,110,26952,7,787225,1015651,228426
73000,641,26889,7,898181,1067746,169565
73000,247,26862,8,867110,1037463,170353
73000,139,26941,7,858653,1056231,197578
73000,495,26991,11,847841,1016268,168427
73000,458,26825,7,899864,1157011,257147
73000,495,26765,8,1081085,1100563,19478
73000,645,26871,7,766021,1086438,320417
73000,114,26843,7,778338,1268460,490122
73000,429,26756,7,920626,957457,36831
73000,487,26930,8,838377,1011236,172859
73000,139,26819,7,934484,1136509,202025
73000,230,26719,7,875920,1289273,413353
73000,95,26866,7,869294,964725,95431
73000,264,26968,8,1018054,1117422,99368
73000,330,26862,7,835121,972641,137520
73000,583,26746,10,908333,1036306,127973
73000,233,26901,7,825887,982237,156350
73000,250,26843,7,952604,1130862,178258
73000,425,26854,8,879529,1032057,152528
73000,147,26839,8,895671,1022153,126482
73000,117,26800,7,842928,959946,117018
73000,190,26865,7,818874,963740,144866
73000,388,26929,8,834882,1068287,233405
73000,523,26951,7,933892,1014607,80715
73000,85,26880,7,821941,1127565,305624
73000,72,26841,7,808514,982585,174071
73000,636,26808,8,812751,1032523,219772
73000,741,26886,8,917074,1015127,98053
73000,302,26684,7,919742,1037431,117689
73000,354,26817,7,924917,993677,68760
73000,292,26817,7,1172066,1180322,8256
73000,129,26822,7,871314,1041038,169724
73000,554,26769,7,1012728,1029389,16661
73000,299,26859,7,850087,1114253,264166
73000,501,26871,8,772004,1026606,254602
73000,751,26918,7,857701,1052603,194902
73000,179,26804,9,816546,1031932,215386
73000,447,26941,7,784326,982189,197863
73000,367,26681,7,831245,1095907,264662
73000,124,26924,8,925997,1012482,86485
73000,545,27029,7,736433,961139,224706
73000,372,26802,7,777988,1155089,377101
73000,429,27103,8,919840,1089135,169295
73000,550,26867,7,812871,1030085,217214
73000,807,27004,7,795053,916793,121740
73000,474,26766,7,842900,984422,141522
74000,414,27271,8,938818,1147503,208685
74000,234,27380,7,872833,1052843,180010
74000,550,27266,7,818241,1126232,307991
74000,264,27152,7,816813,1080856,264043
74000,165,27185,7,1079527,1229593,150066
74000,196,27177,7,874678,951427,76749
74000,57,27151,8,933335,1173647,240312
74000,326,27223,8,826190,1057929,231739
74000,328,27219,8,967864,1126325,158461
74000,352,27200,8,783198,998534,215336
74000,317,27287,7,1062946,1296851,233905
74000,225,27136,7,831068,978405,147337
74000,223,27225,7,897041,1021327,124286
74000,364,27171,8,701685,965349,263664
74000,579,27193,7,905163,974322,69159
74000,168,27132,6,941346,994463,53117
74000,508,27145,7,931769,1212198,280429
74000,203,27230,7,954684,985621,30937
74000,377,27232,8,789108,970016,180908
74000,262,26946,7,794317,1019498,225181
74000,358,27214,8,765609,1104638,339029
74000,196,27168,8,849013,1034738,185725
74000,601,27387,8,740659,1037352,296693
74000,592,27163,8,780221,897547,117326
74000,261,27163,7,869137,1007003,137866
74000,833,27276,8,788348,1025524,237176
74000,38,27313,7,818193,1044914,226721
74000,397,27223,8,763602,988934,225332
74000,137,27191,7,757604,1065854,308250
74000,855,27225,9,747226,1031873,284647
74000,325,27186,8,957024,1229105,272081
74000,438,27238,8,934119,1108702,174583
74000,682,27299,7,930904,1142768,211864
74000,328,27223,8,1120123,1173944,53821
74000,68,27275,8,770669,1052966,282297
74000,439,27025,7,890579,965393,74814
74000,638,27385,9,776732,1106824,330092
74000,310,27127,7,877240,1007116,129876
74000,562,27292,8,788268,1031707,243439
74000,313,27292,8,962724,1127002,164278
74000,425,27239,8,812764,989755,176991
74000,152,27199,8,744662,1100360,355698
74000,229,27280,8,833733,1126537,292804
74000,214,27279,8,869248,990198,120950
74000,570,27237,7,936000,976998,40998
74000,261,27288,8,789014,1036921,247907
74000,191,27284,8,892273,1045544,153271
74000,454,27369,8,755487,1051175,295688
74000,263,27422,7,813965,1111343,297378
74000,309,27307,8,805350,988648,183298
75000,317,27494,8,1052885,1093785,40900
75000,300,27504,7,853189,947740,94551
75000,381,27531,7,1011826,1229104,217278
75000,401,27651,7,859167,1049506,190339
75000,304,27593,8,911599,1044613,133014
75000,314,27556,7,770280,1046062,275782
75000,394,27640,8,1141583,1142468,885
75000,228,27476,9,838804,1014106,175302
75000,365,27499,7,907760,1140519,232759
75000,217,27526,8,828857,1080223,251366
75000,84,27505,7,896318,1050483,154165
75000,426,27670,9,872823,1110582,237759
75000,224,27651,8,1006918,1201583,194665
75000,371,27681,7,980031,1172135,192104
75000,541,27577,7,1022282,1066689,44407
75000,385,27689,8,828145,1129696,301551
75000,331,27463,7,756488,1155360,398872
75000,457,27531,7,864299,1066174,201875
75000,591,27541,8,806412,951353,144941
75000,130,27425,8,816326,1034154,217828
75000,367,27572,7,807491,1327934,520443
75000,275,27437,9,926474,1055613,129139
75000,408,27707,8,762302,1048487,286185
75000,470,27644,9,819895,1133361,313466
75000,642,27564,9,843412,1000326,156914
75000,71,27585,10,822729,991065,168336
75000,146,27551,7,1010276,1062449,52173
75000,373,27588,7,1110795,1123695,12900
75000,421,27608,7,763492,979443,215951
75000,263,27584,8,781303,1041857,260554
75000,400,27672,8,888991,925889,36898
75000,449,27698,7,890722,1052405,161683
75000,175,27708,8,1088007,1195486,107479
75000,379,27434,8,998432,1194205,195773
75000,195,27693,7,807432,1013094,205662
75000,142,27699,7,762612,1265471,502859
75000,446,27543,7,823290,1141662,318372
75000,78,27676,7,994579,1100832,106253
75000,528,27648,8,843740,915331,71591
75000,311,27528,8,896932,1069300,172368
75000,505,27604,7,963579,1052517,88938
75000,478,27559,8,890830,1128280,237450
75000,223,27471,8,724113,956239,232126
75000,123,27580,8,772939,949720,176781
75000,603,27637,7,1006400,1152239,145839
75000,367,27555,7,980424,1069047,88623
75000,411,27674,8,899927,952058,52131
75000,221,27653,8,851644,960547,108903
75000,140,27583,8,866281,1284461,418180
75000,473,27697,8,775730,1134524,358794
76000,645,27791,7,844156,1055479,211323
76000,364,28011,7,818764,1195671,376907
76000,433,28012,8,867527,1075775,208248
76000,148,28026,8,796972,1090589,293617
76000,328,28019,8,1035536,1165337,129801
76000,97,27966,8,939517,1258762,319245
76000,592,27833,8,986201,1024852,38651
76000,263,27949,7,839564,989691,150127
76000,171,27977,7,904459,1070892,166433
76000,378,28073,7,872355,1168090,295735
76000,799,28113,7,970165,1080391,110226
76000,429,28059,7,850247,975216,124969
76000,244,27936,8,809745,1073142,263397
76000,309,27871,8,840868,1017978,177110
76000,415,28028,8,886441,1046216,159775
76000,685,27795,8,882185,1104849,222664
76000,938,28004,8,848834,1123034,274200
76000,553,27923,8,864700,1273739,409039
76000,181,27811,7,954157,1068849,114692
76000,257,28097,8,893022,1136658,243636
76000,668,27943,7,795731,1009116,213385
76000,215,27783,8,767693,1154723,387030
76000,324,28064,9,749305,945976,196671
76000,319,28038,8,832897,1023796,190899
76000,390,27911,7,773893,1152887,378994
76000,374,27852,7,943658,969903,26245
76000,261,28031,7,779681,990257,210576
76000,459,27862,8,932964,1088932,155968
76000,303,27984,7,822879,1001905,179026
76000,531,27962,8,908803,1024858,116055
76000,245,28077,8,1091958,1188046,96088
76000,450,27986,8,817495,1021815,204320
76000,375,28107,8,1081512,1219720,138208
76000,330,28021,7,865768,1123443,257675
76000,126,28059,7,854882,1077982,223100
76000,257,28083,8,745958,1152736,406778
76000,379,27853,9,1126358,1206896,80538
76000,525,28102,8,845737,1007161,161424
76000,367,27903,7,930642,1196410,265768
76000,93,27968,7,827138,1034446,207308
76000,418,27960,7,854869,1032843,177974
76000,416,28034,8,902793,1061496,158703
76000,250,27851,8,834317,1096856,262539
76000,385,28061,7,990907,1061137,70230
76000,432,28010,7,1060630,1123526,62896
76000,568,27893,7,959798,1110742,150944
76000,454,28012,6,952780,1152437,199657
76000,151,27932,8,1092628,1202305,109677
76000,44,28060,8,881250,1127747,246497
76000,552,27931,8,997923,1163865,165942
77000,954,28314,7,840759,1250216,409457
77000,148,28202,8,1053781,1118848,65067
77000,259,28279,8,934955,1147830,212875
77000,458,28447,8,803555,989862,186307
77000,133,28461,8,1083620,1361840,278220
77000,706,28327,7,914869,1093859,178990
77000,94,28363,7,989114,1159349,170235
77000,63,28213,8,944945,1164131,219186
77000,331,28281,8,922910,1158614,235704
77000,484,28528,7,1003835,1187210,183375
77000,263,28511,7,811849,1035016,223167
77000,146,28221,8,944297,1129497,185200
77000,85,28175,7,756508,1026855,270347
77000,315,28238,8,865837,1095162,229325
77000,434,28293,7,757854,1210202,452348
77000,290,28373,8,885634,1042384,156750
77000,489,28190,7,1177238,1262587,85349
77000,304,28343,7,1013353,1106717,93364
77000,373,28341,7,875652,924276,48624
77000,768,28166,9,808025,1113152,305127
77000,381,28306,9,855418,1014388,158970
77000,242,28393,8,1033423,1103300,69877
77000,307,28422,7,1094039,1235388,141349
77000,492,28197,7,857736,1057417,199681
77000,207,28146,8,827969,974887,146918
77000,329,28376,8,840545,1175402,334857
77000,420,28465,7,850366,1168164,317798
77000,675,28233,8,939389,1199370,259981
77000,445,28253,8,827587,1021064,193477
77000,737,28324,8,849827,1040576,190749
77000,737,28338,7,1024120,1069896,45776
77000,68,28468,7,865011,1072980,207969
77000,321,28244,8,851616,1042876,191260
77000,656,28260,7,867906,1352083,484177
77000,405,28299,7,856112,1065251,209139
77000,545,28278,7,847682,982666,134984
77000,38,28464,9,897153,1256601,359448
77000,618,28384,8,1110728,1200407,89679
77000,166,28251,11,808256,1250130,441874
77000,529,28344,7,787200,1189087,401887
77000,232,28341,7,845647,1049756,204109
77000,264,28299,7,897602,1218435,320833
77000,509,28411,7,892521,1275403,382882
77000,574,28316,8,824271,1122634,298363
77000,499,28313,8,855277,1168391,313114
77000,182,28422,8,929702,1004168,74466
77000,466,28529,9,907221,1045907,138686
77000,298,28394,7,937807,1075791,137984
77000,509,28405,8,919774,1000943,81169
77000,203,28335,7,962615,1153622,191007
78000,385,28561,8,939146,1114169,175023
78000,131,28651,8,1040558,1077226,36668
78000,360,28784,8,1113183,1218906,105723
78000,221,28646,8,1293255,1340763,47508
78000,246,28617,8,901805,1157804,255999
78000,290,28587,8,1057136,1249625,192489
78000,314,28710,8,885514,1173992,288478
78000,155,28803,8,904384,1173481,269097
78000,333,28804,8,847591,1095265,247674
78000,123,28657,8,976416,1070789,94373
78000,245,28770,7,943863,1099660,155797
78000,521,28573,7,800986,1100012,299026
78000,373,28727,7,1021314,1130805,109491
78000,671,28752,8,897811,992881,95070
78000,479,28669,8,830494,977154,146660
78000,309,28698,7,979359,1120269,140910
78000,230,28791,7,886067,987360,101293
78000,571,28654,8,723138,1075175,352037
78000,176,28713,8,876769,1249692,372923
78000,743,28614,8,860889,1026784,165895
78000,116,28735,8,876442,1194452,318010
78000,471,28819,8,876017,1375601,499584
78000,371,28454,8,951339,1132144,180805
78000,68,28645,7,889310,1059140,169830
78000,1236,28650,7,783459,1151640,368181
78000,479,28737,7,794096,1026266,232170
78000,655,28735,7,1005471,1163915,158444
78000,307,28823,7,885957,975171,89214
78000,314,28684,7,1139970,1193887,53917
78000,385,28742,9,970762,1073169,102407
78000,66,28668,9,922034,1021526,99492
78000,147,28659,8,881286,1183578,302292
78000,730,28623,8,1076679,1182267,105588
78000,227,28709,8,1019330,1175939,156609
78000,263,28585,8,881142,1105888,224746
78000,239,28627,9,942166,1114908,172742
78000,333,28574,7,904863,1401606,496743
78000,238,28676,7,825934,1110238,284304
78000,157,28798,7,900998,1028657,127659
78000,852,28693,8,990730,1235916,245186
78000,420,28697,7,811294,1117120,305826
78000,133,28756,7,839013,1084603,245590
78000,570,28651,7,920093,1039466,119373
78000,109,28696,8,921614,1222862,301248
78000,372,28766,8,857944,1131594,273650
78000,325,28694,7,799074,1073254,274180
78000,806,28568,8,1025365,1130268,104903
78000,429,28669,7,812058,1036078,224020
78000,356,28529,7,932204,1227443,295239
78000,344,28801,8,851587,1195847,344260
79000,337,29104,8,885394,1052916,167522
79000,299,29017,8,873598,1116569,242971
79000,226,29069,8,1085316,1091548,6232
79000,368,29127,7,843307,1077849,234542
79000,79,29186,8,1065688,1263772,198084
79000,110,28980,7,1086619,1181280,94661
79000,44,29082,9,1066697,1077942,11245
79000,1018,29032,7,1055994,1087617,31623
79000,211,29069,8,1014054,1254104,240050
79000,403,29141,8,824186,1192282,368096
79000,305,29033,7,1036881,1128518,91637
79000,602,29137,9,1140068,1419121,279053
79000,221,29113,8,1102010,1118485,16475
79000,465,29150,7,956035,1192194,236159
79000,147,29231,8,940108,1232997,292889
79000,406,29141,7,852844,1174392,321548
79000,330,29005,8,947796,1148225,200429
79000,480,29016,7,897868,1164794,266926
79000,490,29169,7,937561,1217036,279475
79000,306,29144,7,879641,1146368,266727
79000,573,29009,8,890370,1271389,381019
79000,273,28913,8,989447,1069692,80245
79000,172,29137,8,1003907,1178943,175036
79000,331,29147,7,975383,1199181,223798
79000,76,29060,9,1100297,1147116,46819
79000,390,29154,8,842418,1146888,304470
79000,138,29062,8,875980,1161605,285625
79000,117,29166,7,832647,1156801,324154
79000,80,28903,8,828655,1127680,299025
79000,398,29128,7,881677,1200126,318449
79000,233,29161,8,873245,1116371,243126
79000,347,29025,7,992063,1125302,133239
79000,356,29148,8,776068,1142636,366568
79000,512,28941,7,890205,1492008,601803
79000,365,29064,8,805055,1134802,329747
79000,227,28982,7,970601,1036022,65421
79000,195,29055,8,814393,1151561,337168
79000,175,29189,8,955760,1170267,214507
79000,37,29024,7,850769,1117144,266375
79000,763,28846,8,884787,996685,111898
79000,403,29027,7,1002452,1141642,139190
79000,432,28927,8,975507,1084451,108944
79000,260,28998,7,1074840,1278051,203211
79000,315,28970,7,1022802,1204727,181925
79000,195,28807,7,1032830,1236283,203453
79000,409,29017,8,1012784,1116275,103491
79000,286,29161,8,948224,1116539,168315
79000,420,29181,8,776911,1117249,340338
79000,385,28945,7,1021661,1143390,121729
79000,239,29030,8,902067,1103341,201274
80000,227,29460,8,1040613,1250602,209989
80000,398,29655,8,927907,1000629,72722
80000,589,29545,7,886791,1289213,402422
80000,195,29435,7,1066224,1459249,393025
80000,400,29384,7,898107,1128016,229909
80000,30,29453,7,1133076,1309162,176086
80000,478,29504,8,829718,1183026,353308
80000,565,29513,8,1115411,1238609,123198
80000,179,29360,7,955819,1208829,253010
80000,94,29464,7,855726,1012772,157046
80000,129,29407,7,936752,1109434,172682
80000,281,29428,7,953003,1087091,134088
80000,1035,29283,8,997513,1181285,183772
80000,245,29405,7,998317,1168723,170406
80000,461,29303,7,898445,1229395,330950
80000,507,29370,8,943487,1345342,401855
80000,493,29440,7,938557,1122409,183852
80000,444,29426,7,909600,1099813,190213
80000,852,29362,7,900236,1274349,374113
80000,223,29484,7,891220,1107210,215990
80000,206,29414,7,835205,1078379,243174
80000,303,29442,7,933555,1266891,333336
80000,248,29292,8,1185663,1218042,32379
80000,138,29284,7,945265,1261431,316166
80000,257,29384,7,889072,1320371,431299
80000,237,29392,8,898643,1177139,278496
80000,374,29521,9,1052025,1074347,22322
80000,508,29280,8,908102,1185733,277631
80000,294,29427,8,857612,1090480,232868
80000,227,29376,8,882946,1184462,301516
80000,631,29419,8,1027522,1149595,122073
80000,295,29314,7,1001283,1255661,254378
80000,245,29508,7,915368,1041128,125760
80000,276,29399,9,812842,1142933,330091
80000,322,29420,7,1064303,1252258,187955
80000,158,29486,7,1006265,1054058,47793
80000,393,29456,7,910918,1112604,201686
80000,363,29412,8,1059896,1160024,100128
80000,523,29474,8,813187,1186682,373495
80000,436,29570,7,899337,1055419,156082
80000,266,29526,8,803998,1182814,378816
80000,218,29398,7,1066600,1088102,21502
80000,326,29426,7,844773,1194488,349715
80000,367,29429,7,980086,1194304,214218
80000,542,29435,8,836602,1234848,398246
80000,348,29322,7,912947,1109221,196274
80000,393,29521,8,843150,1035181,192031
80000,118,29293,7,1090550,1218500,127950
80000,69,29512,7,896947,1161875,264928
80000,559,29438,7,984301,1226271,241970
81000,171,29913,7,810187,1125133,314946
81000,108,29829,7,968912,1129215,160303
81000,621,29722,8,892565,1190770,298205
81000,394,29804,7,939714,1190094,250380
81000,116,29887,7,914962,1134049,219087
81000,271,29645,8,866470,1165156,298686
81000,350,29935,7,860360,1061948,201588
81000,188,29726,8,825182,1195364,370182
81000,261,29985,8,935592,1159217,223625
81000,559,29768,7,790162,1056296,266134
81000,306,29745,8,1187756,1193476,5720
81000,112,29675,7,1032165,1555037,522872
81000,378,29972,7,915200,1197634,282434
81000,449,29744,7,975631,1102007,126376
81000,302,29583,7,939519,1310961,371442
81000,331,29765,8,900145,1253140,352995
81000,322,29773,8,944167,1104667,160500
81000,538,29612,9,1025017,1169764,144747
81000,212,29823,7,972002,1120159,148157
81000,253,29740,8,952631,1047534,94903
81000,136,29725,9,997201,1223366,226165
81000,90,29663,7,922447,1123395,200948
81000,256,29783,7,847910,1230732,382822
81000,126,29757,8,1275753,1418693,142940
81000,564,29785,8,998972,1280918,281946
81000,331,29721,8,1051085,1091962,40877
81000,141,29779,8,940161,1349249,409088
81000,163,29790,7,1058277,1109198,50921
81000,468,29904,7,963921,1346705,382784
81000,213,29687,7,890974,1535914,644940
81000,92,29859,8,1231044,1355986,124942
81000,514,29930,8,953226,1202021,248795
81000,525,29670,8,1112623,1291431,178808
81000,164,29772,8,930297,1248251,317954
81000,201,29812,9,824852,1370009,545157
81000,336,29800,7,882571,1212784,330213
81000,294,29909,8,868928,1340178,471250
81000,200,29641,7,957741,1375636,417895
81000,457,29675,7,1098729,1394072,295343
81000,235,29756,7,795037,1256106,461069
81000,143,29783,7,859782,1156088,296306
81000,610,29615,9,1016845,1291035,274190
81000,626,29874,8,1311514,1318867,7353
81000,553,29665,7,1115139,1146117,30978
81000,257,29992,8,1094225,1139912,45687
81000,361,29935,8,820631,1050884,230253
81000,349,29937,8,863142,1215716,352574
81000,539,29822,8,928715,1290016,361301
81000,290,29809,8,967945,1113552,145607
81000,587,29856,8,849412,1061425,212013
82000,640,30297,8,997985,1201113,203128
82000,655,30213,9,895858,1166307,270449
82000,270,30207,8,909935,1160044,250109
82000,295,29961,8,801664,1062568,260904
82000,507,30143,8,838819,1169522,330703
82000,256,30192,9,999255,1231339,232084
82000,661,30160,7,984011,1181876,197865
82000,259,30060,8,911989,1436211,524222
82000,159,30276,7,1013548,1390331,376783
82000,262,30236,8,1033894,1161331,127437
82000,111,30077,7,885270,1165199,279929
82000,271,30187,8,898498,1401593,503095
82000,94,30171,8,1044174,1155117,110943
82000,623,30285,8,1001445,1318151,316706
82000,184,30146,8,938300,1082761,144461
82000,493,30078,7,1120385,1428021,307636
82000,223,30166,8,1161976,1247213,85237
82000,336,29998,7,945560,1196422,250862
82000,387,30280,10,893862,1152343,258481
82000,86,29982,8,863586,1120577,256991
82000,432,30130,8,888380,1160528,272148
82000,263,30031,8,1099893,1371014,271121
82000,95,30248,7,866769,1230590,363821
82000,170,30209,7,830729,1122187,291458
82000,437,30102,7,876103,1334670,458567
82000,146,30137,7,1089952,1202996,113044
82000,436,30229,7,1020379,1185585,165206
82000,119,30123,9,968297,1292867,324570
82000,402,30301,8,939779,1353660,413881
82000,931,30115,8,900128,1035713,135585
82000,477,30112,8,911747,1096507,184760
82000,223,30226,8,1123185,1204682,81497
82000,938,30274,8,952667,1098899,146232
82000,485,30208,7,973789,1211951,238162
82000,128,30249,8,984409,1394657,410248
82000,375,30089,8,1302490,1510978,208488
82000,253,30134,8,1014841,1189334,174493
82000,451,29882,8,1114689,1288082,173393
82000,474,30193,8,952659,1088476,135817
82000,378,30237,7,1049088,1225787,176699
82000,269,30036,8,1081291,1274121,192830
82000,206,30084,9,1018693,1170561,151868
82000,892,30133,8,917486,1136195,218709
82000,15,29983,7,884966,1099759,214793
82000,304,30091,8,1104376,1177287,72911
82000,376,30306,8,980073,1195854,215781
82000,570,30280,8,1096211,1213099,116888
82000,221,30190,7,1045502,1135801,90299
82000,353,30274,8,948957,1048242,99285
82000,308,30073,8,916318,1107734,191416
83000,501,30539,8,1113091,1236717,123626
83000,357,30492,7,924320,1375645,451325
83000,534,30557,7,961009,1282531,321522
83000,170,30416,8,1043771,1250159,206388
83000,341,30406,7,919465,1044878,125413
83000,258,30680,8,895170,1206493,311323
83000,163,30678,8,901678,1323908,422230
83000,717,30525,7,1080152,1475583,395431
83000,534,30479,7,1078992,1355665,276673
83000,620,30493,9,906820,1084673,177853
83000,213,30327,7,1272566,1331125,58559
83000,250,30430,7,953425,1187725,234300
83000,540,30535,8,881285,1150729,269444
83000,511,30438,7,836261,1099329,263068
83000,161,30570,8,1011277,1260615,249338
83000,281,30582,7,887646,1164022,276376
83000,162,30607,7,1021684,1275470,253786
83000,138,30483,7,975994,1110320,134326
83000,592,30554,7,986686,1417969,431283
83000,289,30558,7,1223507,1463913,240406
83000,647,30559,8,859719,1094424,234705
83000,454,30567,8,1178512,1374253,195741
83000,573,30573,9,837381,1150481,313100
83000,184,30415,7,1078076,1127319,49243
83000,701,30466,9,1003699,1132238,128539
83000,516,30573,7,885861,1302991,417130
83000,466,30648,8,921469,1156548,235079
83000,339,30495,8,963818,1174837,211019
83000,216,30544,8,867809,1227703,359894
83000,431,30285,8,808645,1225667,417022
83000,367,30540,7,917568,1152374,234806
83000,239,30601,8,987478,1171877,184399
83000,433,30733,8,970417,1209131,238714
83000,374,30555,8,1065815,1152547,86732
83000,480,30500,8,947471,1157366,209895
83000,476,30582,7,788378,1240134,451756
83000,539,30541,7,900430,1123763,223333
83000,258,30499,7,893780,1248997,355217
83000,570,30621,7,997867,1222624,224757
83000,489,30486,8,939283,1202815,263532
83000,395,30602,8,858403,1242364,383961
83000,205,30488,7,1184792,1244364,59572
83000,624,30631,8,977495,1378072,400577
83000,296,30214,9,1026195,1281885,255690
83000,332,30416,7,1040858,1242627,201769
83000,988,30552,8,1024638,1559763,535125
83000,314,30636,8,959783,1101327,141544
83000,295,30631,8,1104051,1189636,85585
83000,816,30534,7,947273,1426930,479657
83000,256,30547,9,888540,1129632,241092
84000,588,31021,7,824647,1214142,389495
84000,68,30890,7,1117222,1225934,108712
84000,183,30855,8,1186443,1203143,16700
84000,207,30876,7,979069,1042310,63241
84000,272,31043,8,1121229,1271051,149822
84000,201,30843,7,974679,1160682,186003
84000,662,30788,8,867838,1064768,196930
84000,255,30925,7,1010145,1164468,154323
84000,329,30968,7,827604,1184959,357355
84000,191,30871,8,928408,1142570,214162
84000,595,30915,8,834014,1382148,548134
84000,219,30759,7,858930,1116891,257961
84000,140,30942,8,1013617,1242746,229129
84000,319,31027,8,941947,1124672,182725
84000,283,31029,7,1002501,1322603,320102
84000,611,30876,9,942775,1122279,179504
84000,118,31024,7,1082095,1257530,175435
84000,277,30957,8,1015854,1205017,189163
84000,412,30809,7,956768,1315614,358846
84000,428,30957,7,1235851,1297529,61678
84000,63,30818,8,808784,1223014,414230
84000,436,30969,7,1119095,1225558,106463
84000,605,30868,7,943576,1286105,342529
84000,234,30745,8,989484,1478302,488818
84000,171,30878,7,980653,1238523,257870
84000,288,30658,8,963668,1282054,318386
84000,286,30937,7,1027745,1319272,291527
84000,436,30899,8,810466,1143722,333256
84000,268,30928,8,1073050,1190673,117623
84000,213,30846,7,879057,1086305,207248
84000,291,30982,8,1138764,1452260,313496
84000,563,30840,8,1020951,1120158,99207
84000,537,30876,8,1003817,1231307,227490
84000,376,30920,7,969231,1352052,382821
84000,274,30884,8,824766,1326787,502021
84000,468,30899,8,850543,1124736,274193
84000,250,30940,8,879240,1095994,216754
84000,154,30952,8,925861,1223375,297514
84000,536,30894,7,1050758,1287374,236616
84000,648,30880,8,926294,1217384,291090
84000,264,30775,7,1157870,1168692,10822
84000,529,30833,8,1301739,1455093,153354
84000,644,30837,7,1031952,1181602,149650
84000,494,30926,7,986846,1442999,456153
84000,202,30776,7,1037584,1130350,92766
84000,511,30781,8,992957,1212847,219890
84000,663,30882,8,1087039,1243519,156480
84000,251,30966,8,1032395,1168256,135861
84000,955,31081,7,896364,1211664,315300
84000,332,30747,7,1140996,1143702,2706
85000,431,31279,8,1031110,1127190,96080
85000,370,31308,9,1129781,1348051,218270
85000,308,31220,8,942309,1166849,224540
85000,175,31282,8,1145541,1206627,61086
85000,292,31175,8,914987,1051968,136981
85000,181,31232,8,892112,1196710,304598
85000,271,31359,7,1026048,1170777,144729
85000,395,31168,8,1077518,1124610,47092
85000,115,31076,7,1187034,1329652,142618
85000,909,31329,8,952380,1134764,182384
85000,112,31197,7,1099036,1214327,115291
85000,632,31307,7,934602,1242086,307484
85000,923,31264,7,1046182,1258239,212057
85000,576,31230,7,908463,1130625,222162
85000,485,31213,8,1106518,1298306,191788
85000,188,31393,7,1071514,1366398,294884
85000,372,31200,8,915291,1093560,178269
85000,405,31177,8,1089382,1183549,94167
85000,418,31366,8,920682,1327928,407246
85000,435,31101,7,1254792,1265063,10271
85000,675,31316,8,917886,1118879,200993
85000,578,31291,7,895087,1107407,212320
85000,352,31257,7,932006,1161554,229548
85000,143,31210,7,1042327,1254039,211712
85000,401,31191,7,1168900,1254527,85627
85000,187,31170,8,1100437,1208763,108326
85000,252,31283,7,1057442,1239826,182384
85000,427,31277,8,961470,1310834,349364
85000,646,31348,7,1046447,1344163,297716
85000,309,31236,8,1175003,1285094,110091
85000,26,31346,8,840996,1355484,514488
85000,559,31376,7,1087818,1303952,216134
85000,468,31186,8,956629,1146237,189608
85000,188,31288,7,983387,1169885,186498
85000,233,31247,7,1068199,1181887,113688
85000,313,31195,8,949180,1112568,163388
85000,547,31342,7,1316594,1516479,199885
85000,823,31302,8,888152,1198194,310042
85000,35,31209,7,885945,1150563,264618
85000,569,31221,8,1176388,1293249,116861
85000,347,31272,7,1161111,1242269,81158
85000,526,31352,8,926995,1123037,196042
85000,441,31352,7,1042340,1173081,130741
85000,542,31210,8,1016280,1151708,135428
85000,295,31217,8,1207665,1220365,12700
85000,265,31173,7,941259,1157492,216233
85000,609,31283,7,966042,1236138,270096
85000,346,31171,7,1110015,1256090,146075
85000,616,31300,7,1077147,1398244,321097
85000,206,31144,8,984965,1326186,341221
86000,615,31530,9,1078033,1389025,310992
86000,579,31669,8,862365,1123350,260985
86000,158,31748,8,1099119,1275122,176003
86000,422,31630,7,1009780,1187821,178041
86000,471,31540,7,1091675,1162294,70619
86000,524,31648,8,1069486,1308464,238978
86000,13,31741,8,959653,1213310,253657
86000,342,31740,8,1049997,1243712,193715
86000,307,31551,7,991248,1448585,457337
86000,212,31717,8,895444,1130581,235137
86000,514,31512,9,1151889,1281398,129509
86000,360,31699,8,870325,1196650,326325
86000,49,31568,8,1025803,1478966,453163
86000,1180,31671,7,940521,1281148,340627
86000,183,31661,7,971949,1123060,151111
86000,356,31713,7,979036,1177612,198576
86000,710,31617,8,1004588,1223845,219257
86000,329,31737,9,975557,1386660,411103
86000,401,31596,7,921662,1209336,287674
86000,207,31603,7,960570,1472851,512281
86000,495,31712,9,914721,1147107,232386
86000,434,31493,7,988454,1324962,336508
86000,67,31828,8,1080285,1155118,74833
86000,465,31543,8,910868,1305394,394526
86000,562,31743,7,1555130,1604362,49232
86000,554,31646,8,1015248,1234420,219172
86000,767,31711,8,925243,1103330,178087
86000,278,31572,8,965890,1165376,199486
86000,480,31557,7,932126,1163709,231583
86000,57,31602,8,1025128,1436501,411373
86000,227,31723,8,969790,1164048,194258
86000,216,31644,7,887060,1195937,308877
86000,355,31637,8,1013010,1457561,444551
86000,187,31517,8,1155906,1217179,61273
86000,744,31725,7,979592,1308720,329128
86000,102,31657,8,1013553,1105246,91693
86000,321,31817,8,996473,1266337,269864
86000,362,31678,7,1107860,1353388,245528
86000,237,31633,8,822854,1188624,365770
86000,286,31583,7,1060629,1232117,171488
86000,619,31575,7,954873,1252272,297399
86000,534,31724,8,1018208,1220306,202098
86000,213,31845,8,993523,1187930,194407
86000,453,31443,8,1029627,1196355,166728
86000,519,31504,7,990373,1805548,815175
86000,582,31764,8,939358,1346044,406686
86000,125,31759,7,940513,1283509,342996
86000,287,31556,8,994932,1220430,225498
86000,443,31756,7,927250,1276555,349305
86000,222,31577,7,1318608,1364786,46178
87000,656,31820,7,1083854,1296093,212239
87000,610,31923,8,969031,1340052,371021
87000,348,31847,9,1257420,1459486,202066
87000,422,32080,8,996941,1111468,114527
87000,153,32064,7,1350451,1527840,177389
87000,454,31928,8,933602,1373266,439664
87000,152,31906,7,947251,1204511,257260
87000,442,32007,8,1011530,1248778,237248
87000,190,31882,7,1032041,1213494,181453
87000,309,31997,7,1147489,1207414,59925
87000,350,32121,8,1010027,1205376,195349
87000,292,32065,8,1219514,1294469,74955
87000,464,32060,7,961788,1270641,308853
87000,261,32089,7,1148121,1287999,139878
87000,500,32034,9,930765,1226500,295735
87000,562,31959,9,920840,1214236,293396
87000,508,32052,8,947438,1161886,214448
87000,714,32067,8,868828,1168186,299358
87000,366,32010,7,1015194,1138355,123161
87000,421,31966,8,1036632,1411578,374946
87000,221,32276,8,988241,1213106,224865
87000,287,32284,7,971201,1161693,190492
87000,274,31824,8,1065211,1186025,120814
87000,448,31984,8,925723,1212682,286959
87000,709,31987,8,1248768,1471868,223100
87000,422,32065,9,1096385,1681510,585125
87000,262,32137,8,1070607,1267560,196953
87000,328,31993,7,878071,1107371,229300
87000,346,31948,7,1372607,1404267,31660
87000,361,32079,7,1061258,1297728,236470
87000,300,32019,8,1117515,1215456,97941
87000,240,32040,7,1012482,1390556,378074
87000,494,31982,7,1032777,1302396,269619
87000,87,32050,7,1320959,1362889,41930
87000,1004,32144,7,1073218,1282484,209266
87000,230,32116,7,1041055,1433278,392223
87000,1134,31831,8,899137,1156255,257118
87000,469,32120,9,1043543,1249105,205562
87000,574,31955,8,864541,1347205,482664
87000,340,32163,7,1037666,1149514,111848
87000,220,31984,8,940932,1324527,383595
87000,294,32107,7,1107578,1292979,185401
87000,452,32251,8,904647,1204990,300343
87000,35,32120,9,1110493,1379708,269215
87000,558,32013,8,1113996,1282490,168494
87000,129,31955,8,1007122,1308818,301696
87000,381,32088,8,977924,1240556,262632
87000,135,32125,7,1421151,1437289,16138
87000,138,32031,7,857113,1242075,384962
87000,367,32078,7,996501,1189451,192950
88000,300,32478,8,993225,1190391,197166
88000,291,32280,8,957317,1334859,377542
88000,374,32444,8,983204,1258575,275371
88000,821,32279,7,1212118,1232318,20200
88000,310,32501,7,1073579,1170807,97228
88000,441,32326,7,1202474,1278252,75778
88000,639,32435,8,918968,1220866,301898
88000,379,32354,8,1162940,1353365,190425
88000,100,32370,7,1104292,1196159,91867
88000,132,32369,7,1090512,1505229,414717
88000,275,32439,8,941754,1178732,236978
88000,430,32358,7,1168549,1250903,82354
88000,465,32325,7,1005900,1223335,217435
88000,815,32424,8,1005437,1276786,271349
88000,324,32250,8,1170717,1293660,122943
88000,734,32325,7,1099547,1297000,197453
88000,451,32422,8,1227244,1230989,3745
88000,425,32324,9,965209,1229230,264021
88000,105,32294,10,1136418,2005837,869419
88000,536,32383,7,1044857,1297440,252583
88000,208,32539,8,1168130,1327703,159573
88000,251,32144,7,1318967,1647049,328082
88000,482,32385,8,1137582,1246519,108937
88000,286,32366,7,1047742,1235866,188124
88000,151,32446,9,1228827,1246318,17491
88000,305,32553,7,925424,1304824,379400
88000,90,32249,8,1007222,1242834,235612
88000,259,32339,9,1210167,1533484,323317
88000,513,32317,8,1011258,1255738,244480
88000,375,32420,7,1267348,1293893,26545
88000,218,32306,8,971767,1127723,155956
88000,308,32316,7,991101,1332424,341323
88000,342,32359,8,1076973,1315178,238205
88000,165,32457,8,941554,1240583,299029
88000,420,32504,8,1039554,1431011,391457
88000,107,32333,7,1152623,1757928,605305
88000,414,32624,8,912837,1241826,328989
88000,191,32243,8,947891,1376807,428916
88000,438,32461,8,984484,1248891,264407
88000,613,32408,7,1063792,1316410,252618
88000,509,32519,7,970036,1146391,176355
88000,187,32418,7,1202039,1412446,210407
88000,193,32334,8,1030636,1351062,320426
88000,448,32364,8,1097814,1197080,99266
88000,355,32280,7,1068422,1176399,107977
88000,349,32581,8,975016,1073280,98264
88000,648,32248,7,1116605,1239179,122574
88000,1138,32191,7,1191628,1371941,180313
88000,431,32414,8,1117590,1191235,73645
88000,603,32320,7,992421,1352705,360284
89000,309,32773,8,945975,1310790,364815
89000,299,32741,8,1058519,1317503,258984
89000,365,32723,7,1025952,1509611,483659
89000,462,32618,8,1128964,1217761,88797
89000,110,32586,7,1047733,1164451,116718
89000,251,32855,7,1108622,1429458,320836
89000,408,32658,7,1008240,1394182,385942
89000,541,32856,9,1131873,1255106,123233
89000,659,32737,7,1025460,1389515,364055
89000,455,32763,7,1073530,1316255,242725
89000,683,32584,7,931547,1390377,458830
89000,461,32694,8,977407,1216428,239021
89000,255,32902,8,1104928,1231552,126624
89000,351,32894,7,1040196,1241352,201156
89000,85,32960,7,1005873,1441224,435351
89000,732,32601,7,913770,1381169,467399
89000,439,32568,8,1110421,1373499,263078
89000,290,32738,8,937863,1416577,478714
89000,210,32740,8,1080345,1216041,135696
89000,430,32723,7,1037140,1264246,227106
89000,298,32669,8,1029383,1242954,213571
89000,368,32707,7,978951,1188640,209689
89000,62,32624,7,1114240,1179039,64799
89000,55,32724,8,1006850,1326521,319671
89000,403,32812,8,1010208,1350502,340294
89000,683,32825,8,1001154,1400070,398916
89000,580,32652,9,952271,1331490,379219
89000,283,32449,7,947134,1130716,183582
89000,712,32827,7,951239,1307425,356186
89000,318,32833,8,1088392,1259152,170760
89000,359,32689,7,1015330,1228435,213105
89000,348,32640,7,913014,1642709,729695
89000,218,32748,7,1035183,1436399,401216
89000,198,32736,8,1140764,1330441,189677
89000,797,32618,8,1048378,1306799,258421
89000,147,32689,8,985109,1331720,346611
89000,465,32685,10,1064105,1157839,93734
89000,172,32659,8,1150433,1296800,146367
89000,202,32779,8,1032912,1275187,242275
89000,628,32803,7,1048380,1171136,122756
89000,507,32742,7,1076043,1326325,250282
89000,458,32886,8,1066326,1283416,217090
89000,377,32742,8,1057912,1172430,114518
89000,512,32728,7,1031948,1358279,326331
89000,330,32922,8,1027871,1234803,206932
89000,591,32657,8,978709,1221984,243275
89000,574,32673,7,965128,1182609,217481
89000,364,32837,8,1088357,1418871,330514
89000,213,32592,8,1059943,1248032,188089
89000,177,32697,8,1213468,1469631,256163
90000,479,33270,7,1051669,1188713,137044
90000,261,32990,8,953575,1184539,230964
90000,411,33044,8,1056116,1247244,191128
90000,51,33048,8,1071640,1309699,238059
90000,555,33024,7,1306541,1376222,69681
90000,394,33135,8,1307823,1557020,249197
90000,623,33033,7,1144699,1463497,318798
90000,337,33029,7,901524,1143450,241926
90000,56,33033,7,990328,1328744,338416
90000,117,33065,8,1179902,1387532,207630
90000,122,33042,8,997336,1145931,148595
90000,125,33054,9,1171895,1526713,354818
90000,667,33136,7,1127756,1528067,400311
90000,320,33156,7,1149217,1242434,93217
90000,246,33026,8,1233523,1503462,269939
90000,284,33130,7,1039348,1244775,205427
90000,211,33146,8,1174630,1209909,35279
90000,696,32983,8,1203446,1323210,119764
90000,214,33118,7,1353446,1544262,190816
90000,426,33128,7,1135267,1340146,204879
90000,140,33247,7,946962,1466469,519507
90000,442,33173,7,1118705,1197353,78648
90000,316,33072,8,931537,1387182,455645
90000,414,33079,8,913028,1397230,484202
90000,297,33142,8,1050776,1259282,208506
90000,411,33278,8,1143208,1277455,134247
90000,121,32985,7,1165344,1166550,1206
90000,100,33005,9,1257491,1464653,207162
90000,294,33229,7,953497,1265666,312169
90000,391,33229,9,1167115,1298545,131430
90000,305,33214,7,1191864,1347252,155388
90000,135,33194,8,1089041,1216869,127828
90000,768,33240,7,1163877,1299857,135980
90000,226,32988,8,1091926,1315203,223277
90000,329,33177,7,977845,1228981,251136
90000,343,33117,7,913471,1340736,427265
90000,253,33119,8,1362185,1377634,15449
90000,430,33014,7,1068024,1225494,157470
90000,210,33150,8,1027011,1505237,478226
90000,735,33075,7,1087543,1225008,137465
90000,299,33192,7,1052738,1219415,166677
90000,462,33101,7,1157328,1323459,166131
90000,302,33092,8,1205018,1284470,79452
90000,601,33145,8,1001719,1233874,232155
90000,372,33094,7,1039472,1248071,208599
90000,206,33221,8,1149542,1487360,337818
90000,493,32936,8,1316987,1415901,98914
90000,301,33083,7,1057808,1507003,449195
90000,36,33071,8,1035449,1190978,155529
90000,405,33197,8,1230754,1550355,319601
91000,581,33364,7,1135843,1395596,259753
91000,1051,33525,8,1119178,1319270,200092
91000,265,33576,8,1053970,1407120,353150
91000,216,33567,7,1028319,1215209,186890
91000,568,33546,7,1055335,1312095,256760
91000,763,33447,9,972858,1286562,313704
91000,173,33560,7,1105335,1289995,184660
91000,263,33448,9,981842,1507425,525583
91000,231,33447,7,1190057,1547887,357830
91000,239,33395,8,948968,1122608,173640
91000,466,33530,8,1160195,1466562,306367
91000,522,33391,9,1080155,1192076,111921
91000,578,33757,7,1050007,1261654,211647
91000,381,33394,7,981853,1257510,275657
91000,709,33304,8,1120906,1328148,207242
91000,794,33612,8,940741,1142849,202108
91000,293,33676,9,1174526,1368977,194451
91000,690,33499,7,1044678,1107536,62858
91000,325,33496,9,1174864,1405567,230703
91000,308,33444,7,1016243,1381737,365494
91000,318,33486,7,1316337,1422720,106383
91000,350,33615,7,1006866,1319368,312502
91000,479,33420,8,1078142,1298901,220759
91000,214,33555,7,1136285,1459781,323496
91000,632,33459,8,1237600,1451114,213514
91000,439,33481,8,1292901,1431569,138668
91000,338,33435,9,1081709,1316161,234452
91000,296,33550,9,912234,1251229,338995
91000,355,33511,8,1124843,1458281,333438
91000,460,33607,7,1132454,1487522,355068
91000,149,33589,7,1171890,1309401,137511
91000,518,33578,8,1180759,1339134,158375
91000,373,33496,8,1113029,1281933,168904
91000,339,33525,7,1048698,1440871,392173
91000,514,33650,8,1003325,1207691,204366
91000,229,33486,9,1172665,1277328,104663
91000,620,33551,7,1014569,1271657,257088
91000,121,33371,8,1072664,1373365,300701
91000,210,33494,7,1164671,1262184,97513
91000,367,33558,7,1088779,1383221,294442
91000,36,33493,8,1204872,1230936,26064
91000,232,33535,7,993708,1145609,151901
91000,631,33430,8,1122168,1356413,234245
91000,237,33545,8,1064346,1248405,184059
91000,176,33498,8,1237346,1278651,41305
91000,429,33572,8,1415827,1444765,28938
91000,361,33463,7,1097865,1283498,185633
91000,183,33376,8,1011722,1580200,568478
91000,347,33672,8,1373052,1662832,289780
91000,68,33454,8,951467,1309425,357958
92000,191,34038,8,953818,1145500,191682
92000,400,34037,8,1002694,1318204,315510
92000,546,33937,9,1087436,1211629,124193
92000,921,33913,8,969951,1207448,237497
92000,249,33882,8,1034102,1262669,228567
92000,417,33830,8,964030,1165788,201758
92000,271,33737,7,1231692,1579719,348027
92000,839,33885,7,1117812,1257910,140098
92000,270,33634,7,1070699,1386906,316207
92000,79,33708,9,988243,1347499,359256
92000,233,33831,7,1045818,1391787,345969
92000,198,33814,8,1079504,1377293,297789
92000,287,33806,8,985199,1292182,306983
92000,167,33826,7,1084026,1246866,162840
92000,138,33845,8,1051379,1308158,256779
92000,348,33920,7,1070954,1189650,118696
92000,483,33892,8,1036240,1365297,329057
92000,482,33966,7,1174609,1371581,196972
92000,531,33829,7,1357357,1378685,21328
92000,196,33622,8,987360,1309812,322452
92000,442,33976,7,986764,1275519,288755
92000,153,33801,9,1032695,1373566,340871
92000,522,33763,8,1196518,1310238,113720
92000,480,33795,7,1224960,1467913,242953
92000,78,33773,8,1167038,1289155,122117
92000,288,33724,7,902994,1256598,353604
92000,409,33888,8,1114886,1180953,66067
92000,387,33767,9,1180977,1203206,22229
92000,150,33855,7,1269156,1424678,155522
92000,446,33863,7,1027847,1478505,450658
92000,376,33848,7,1163712,1274998,111286
92000,319,33799,8,1109375,1272756,163381
92000,511,33950,8,1283538,1324164,40626
92000,520,33642,7,1314137,1401742,87605
92000,992,33880,8,1295224,1368570,73346
92000,514,33844,7,1207353,1245165,37812
92000,248,33806,8,1051242,1193949,142707
92000,648,33725,7,1046920,1325120,278200
92000,298,33830,7,1245709,1484042,238333
92000,416,33829,8,996222,1307666,311444
92000,473,33967,9,949640,1319867,370227
92000,581,33776,7,1111186,1335117,223931
92000,212,34068,8,930976,1336463,405487
92000,515,33833,7,979352,1204574,225222
92000,409,33673,9,1104221,1268427,164206
92000,471,33829,9,1160401,1256389,95988
92000,357,33885,10,1058717,1164197,105480
92000,99,33861,8,1188255,1290454,102199
92000,168,33810,8,1114231,1685699,571468
92000,205,33790,8,1052336,1340132,287796
93000,536,34289,8,1101663,1524541,422878
93000,144,34285,7,1227178,1323215,96037
93000,272,34326,8,1209673,1437123,227450
93000,97,34368,8,1154938,1185696,30758
93000,469,34308,7,1057092,1300557,243465
93000,234,34221,7,952358,1160998,208640
93000,576,34170,7,940124,1280047,339923
93000,375,34125,8,1102064,1379557,277493
93000,297,34284,9,1293341,1428026,134685
93000,229,34194,8,925458,1430651,505193
93000,200,34097,7,1007156,1364084,356928
93000,345,34211,7,1106883,1283164,176281
93000,621,34301,7,957404,1297533,340129
93000,123,34171,8,1001279,1300564,299285
93000,358,34237,8,1010938,1360118,349180
93000,247,34244,8,1087710,1530942,443232
93000,376,34382,8,968151,1410781,442630
93000,124,34116,9,1042287,1184213,141926
93000,773,34146,8,1342441,1731180,388739
93000,236,34324,8,1124680,1290119,165439
93000,206,34253,7,1423790,1462576,38786
93000,291,34284,8,1428768,1641424,212656
93000,408,34343,8,1192505,1421257,228752
93000,487,34242,7,1173931,1412515,238584
93000,460,34143,9,1158903,1461461,302558
93000,268,34210,8,1054891,1287070,232179
93000,242,34384,8,1096658,1301149,204491
93000,1078,34275,7,1090787,1495649,404862
93000,545,34266,7,1228576,1511283,282707
93000,363,34462,8,1109549,1358508,248959
93000,353,34122,8,1334555,1374738,40183
93000,494,34240,8,989455,1548007,558552
93000,376,34230,8,1189116,1309774,120658
93000,73,34278,8,1189690,1370139,180449
93000,453,34116,8,1188778,1288452,99674
93000,120,34043,8,1126619,1408036,281417
93000,49,34023,7,1057286,1550536,493250
93000,411,34146,8,1445344,1492292,46948
93000,220,34177,7,1093367,1417852,324485
93000,252,34138,7,1268693,1383593,114900
93000,515,34310,8,1240938,1461620,220682
93000,241,34124,7,1151664,1361142,209478
93000,380,34265,7,1209631,1366728,157097
93000,83,34254,8,1344442,1386792,42350
93000,254,34282,7,1161880,1268289,106409
93000,296,34099,8,943979,1279702,335723
93000,168,34139,8,1010326,1250689,240363
93000,325,34195,8,1009118,1342440,333322
93000,169,34156,8,1314783,1531366,216583
93000,458,34151,8,1179004,1686436,507432
94000,185,34651,8,1062831,1641092,578261
94000,285,34361,8,1090477,1138774,48297
94000,548,34692,8,926530,1254015,327485
94000,332,34659,8,1234503,1370139,135636
94000,341,34597,7,1166498,1244810,78312
94000,1397,34479,8,1021498,1215259,193761
94000,176,34592,8,1077963,1326034,248071
94000,433,34548,7,1146023,1562947,416924
94000,363,34468,7,1003395,1264984,261589
94000,510,34608,7,978621,1311329,332708
94000,77,34481,7,1140515,1593619,453104
94000,203,34498,8,1119181,1366401,247220
94000,775,34453,8,1063061,1347267,284206
94000,257,34516,8,1087089,1454272,367183
94000,328,34680,8,1105300,1431008,325708
94000,278,34570,8,1103432,1468802,365370
94000,67,34709,8,1099970,1347748,247778
94000,469,34552,9,1023912,1321286,297374
94000,294,34434,8,1011660,1444531,432871
94000,335,34683,8,1117412,1292764,175352
94000,117,34533,8,1009733,1185049,175316
94000,806,34481,8,1121892,1295510,173618
94000,406,34741,9,1432792,1486709,53917
94000,618,34530,8,1112895,1786073,673178
94000,389,34575,7,1092921,1172478,79557
94000,804,34738,8,1179246,1470718,291472
94000,621,34526,8,1146728,1387916,241188
94000,530,34558,9,1155832,1375792,219960
94000,379,34689,8,1115574,1332041,216467
94000,653,34632,9,1275089,1296123,21034
94000,361,34547,8,1081227,1405104,323877
94000,303,34502,8,1164569,1287686,123117
94000,290,34517,8,1038391,1323828,285437
94000,460,34639,7,1284074,1398678,114604
94000,187,34575,8,1006322,1350426,344104
94000,339,34524,8,1036381,1573808,537427
94000,412,34605,8,1191051,1272802,81751
94000,1032,34691,8,1245705,1262078,16373
94000,239,34665,8,1025872,1288253,262381
94000,133,34636,8,1107780,1451146,343366
94000,413,34918,8,970014,1385586,415572
94000,254,34537,8,1311544,1330287,18743
94000,192,34551,8,1061703,1199458,137755
94000,411,34649,7,1157732,1302369,144637
94000,589,34587,8,1083425,1193694,110269
94000,578,34581,8,1081628,1532200,450572
94000,596,34651,7,1032947,1261695,228748
94000,671,34526,8,1091150,1552778,461628
94000,233,34516,8,1160117,1477907,317790
94000,693,34685,7,1075259,1284427,209168
95000,880,35002,7,1139231,1251953,112722
95000,39,34973,7,1255885,1399050,143165
95000,225,35049,8,1103441,1317331,213890
95000,656,34881,8,1017646,1232337,214691
95000,56,34931,8,1110620,1283391,172771
95000,251,34892,8,1201696,1402198,200502
95000,492,34837,9,994187,1180813,186626
95000,420,34834,7,1289443,1299052,9609
95000,349,34929,8,1077755,1385014,307259
95000,333,34776,7,1122106,1320170,198064
95000,670,34922,8,1097830,1289692,191862
95000,355,34756,8,1041262,1389321,348059
95000,364,35095,8,1137773,1307346,169573
95000,375,34897,7,1107580,1322142,214562
95000,896,34901,8,1264916,1370329,105413
95000,755,34896,8,1081027,1332064,251037
95000,30,34929,7,1132298,1281180,148882
95000,733,34988,7,1244558,1440120,195562
95000,152,34740,7,1221264,1339340,118076
95000,486,35234,8,1117922,1651407,533485
95000,385,34860,7,1261397,1508034,246637
95000,306,35023,9,1127887,1323428,195541
95000,169,34903,8,1186668,1829342,642674
95000,237,34907,7,1182504,1235624,53120
95000,719,34911,8,1059729,1232917,173188
95000,124,34978,7,1119323,1583724,464401
95000,626,34995,8,1146406,1470635,324229
95000,123,35095,7,1277784,1383688,105904
95000,362,34856,9,1280538,1566420,285882
95000,559,34898,8,1186361,1409850,223489
95000,261,35098,7,1069717,1436720,367003
95000,360,34916,7,1131443,1744639,613196
95000,483,35130,7,1323066,1727587,404521
95000,345,35088,8,1131687,1276933,145246
95000,153,34707,8,1270161,1502954,232793
95000,274,34944,7,1150911,1351703,200792
95000,315,34863,8,1134244,1212388,78144
95000,339,35038,8,1392145,1514687,122542
95000,473,35083,8,1033523,1385065,351542
95000,167,35008,7,1049733,1297399,247666
95000,673,35067,8,1073031,1283557,210526
95000,640,34994,7,1246275,1555539,309264
95000,546,35141,7,1059604,1302922,243318
95000,508,35033,7,961249,1391985,430736
95000,68,34931,8,1163222,1419945,256723
95000,783,35002,8,1346019,1354918,8899
95000,519,34831,8,1206827,1371787,164960
95000,172,35011,8,1246950,1373183,126233
95000,222,34888,8,1049952,1509327,459375
95000,614,35017,7,1071762,1481510,409748
96000,315,35253,8,1077290,1184143,106853
96000,374,35401,8,1238354,1345052,106698
96000,271,35188,7,1116615,1394308,277693
96000,354,35474,9,1137311,1430255,292944
96000,154,35229,8,1302649,1623770,321121
96000,233,35576,8,1219034,1297695,78661
96000,436,35239,8,931390,1299272,367882
96000,616,35192,8,1162617,1579496,416879
96000,479,35294,7,1042638,1216293,173655
96000,324,35425,7,1032913,1551719,518806
96000,337,35295,7,1115297,1371164,255867
96000,150,35176,8,1039515,1360610,321095
96000,112,35306,7,1023300,1272228,248928
96000,347,35159,8,1057277,1406093,348816
96000,335,35203,7,1211873,1454894,243021
96000,256,35331,8,1168916,1479833,310917
96000,328,35456,8,1284554,1366838,82284
96000,244,35371,9,1113057,1376154,263097
96000,428,35342,8,1086219,1340947,254728
96000,316,35233,8,1175474,1436294,260820
96000,145,35401,9,1399413,1514006,114593
96000,282,35248,8,1231189,1338454,107265
96000,277,35235,7,1040091,1307899,267808
96000,156,35342,8,1164585,1464741,300156
96000,142,35243,7,1060956,1314265,253309
96000,511,35363,8,1084811,1355746,270935
96000,456,35319,7,1110841,1258146,147305
96000,519,35300,8,1521247,1576651,55404
96000,53,35191,7,1126750,1387406,260656
96000,235,35328,7,1187933,1537758,349825
96000,200,35431,7,1322430,1686117,363687
96000,762,35420,9,1034532,1454127,419595
96000,608,35272,8,1021565,1385929,364364
96000,226,35379,7,927241,1225844,298603
96000,363,35369,8,1135818,1741813,605995
96000,789,35110,8,987573,1773916,786343
96000,108,35306,7,1173613,1530028,356415
96000,87,35314,8,1136645,1496132,359487
96000,701,35271,7,1039913,1519306,479393
96000,598,35189,8,1180348,1333223,152875
96000,503,35136,7,1399244,1471710,72466
96000,509,35238,7,1132951,1367195,234244
96000,153,35099,8,1252945,1430563,177618
96000,247,35377,8,1040390,1441412,401022
96000,565,35366,8,1004828,1307780,302952
96000,128,35425,8,1159048,1232495,73447
96000,227,35478,8,1105855,1289859,184004
96000,384,35151,8,997794,1385110,387316
96000,559,35352,7,1097154,1366805,269651
96000,179,35385,9,1287274,1467673,180399
97000,231,35672,9,1495209,1533053,37844
97000,324,35564,8,1461346,1582427,121081
97000,471,35563,9,1083782,1552955,469173
97000,442,35721,8,1095628,1362860,267232
97000,365,35691,7,1089980,1278589,188609
97000,125,35766,7,1023649,1443895,420246
97000,542,35740,7,1488020,1503622,15602
97000,532,35892,7,1199353,1288814,89461
97000,238,35728,9,1064011,1417765,353754
97000,318,35710,8,1100204,1460501,360297
97000,340,35591,7,1019867,1290080,270213
97000,361,35807,8,1012706,1487928,475222
97000,557,35646,9,1500739,1720723,219984
97000,150,35740,9,1053268,1493309,440041
97000,237,35583,7,1185060,1474204,289144
97000,753,35667,9,1259550,1356800,97250
97000,313,35711,8,1183619,1262382,78763
97000,566,35602,8,1145863,1356121,210258
97000,1001,35598,9,1197617,1380522,182905
97000,222,35604,9,1179751,1678868,499117
97000,352,35628,8,1058317,1306099,247782
97000,751,35664,9,1200551,1380520,179969
97000,85,35750,8,1058402,1388792,330390
97000,341,35752,8,1104212,1475313,371101
97000,405,35698,7,1659398,1664243,4845
97000,66,35680,7,1228014,1392950,164936
97000,201,35510,8,1195712,1459990,264278
97000,407,35822,9,1086080,1417185,331105
97000,463,35731,8,1317100,1476840,159740
97000,728,35606,7,1032493,1343465,310972
97000,491,35634,7,1075041,1754912,679871
97000,110,35784,7,1089380,1463608,374228
97000,399,35655,9,1072087,1312903,240816
97000,70,35605,7,1013855,1315636,301781
97000,176,35799,8,995693,1322334,326641
97000,553,35737,7,1118328,1299019,180691
97000,692,35800,8,1379362,1527048,147686
97000,194,35696,7,1186244,1525538,339294
97000,379,35706,8,1104149,1410572,306423
97000,359,35639,7,1150276,1345122,194846
97000,406,35605,8,1079249,1463569,384320
97000,391,35671,7,1162658,1981527,818869
97000,181,35746,7,1022711,1639956,617245
97000,558,35762,7,1116718,1890226,773508
97000,248,35554,8,1114799,1461279,346480
97000,307,35767,8,1140827,1586817,445990
97000,519,35665,8,1063737,1457206,393469
97000,282,35708,8,1096661,1740674,644013
97000,398,35577,7,1171277,1221056,49779
97000,660,35723,8,1140043,1457364,317321
98000,302,35916,8,1166696,1465200,298504
98000,493,36064,8,1387093,1496618,109525
98000,532,35996,7,1076559,1335277,258718
98000,248,36102,8,1199376,1332259,132883
98000,255,36090,9,1544092,1594611,50519
98000,539,35937,7,1115126,1399226,284100
98000,634,36134,7,1209811,1457891,248080
98000,369,36032,7,1025864,1249805,223941
98000,176,35866,7,1137853,1583534,445681
98000,579,36128,9,1141641,1334417,192776
98000,572,36034,8,1105089,1451863,346774
98000,379,36267,8,1090268,1331473,241205
98000,281,36014,7,1296262,1608982,312720
98000,141,36050,7,1131888,1402331,270443
98000,508,36020,8,995545,1434781,439236
98000,54,36079,8,1049917,1345208,295291
98000,605,36235,8,1225918,1563884,337966
98000,37,36124,8,1195543,1306058,110515
98000,544,36049,8,1185630,1502967,317337
98000,256,36211,8,1348591,1496744,148153
98000,168,35998,7,1197699,1303067,105368
98000,618,36205,8,990046,1571175,581129
98000,317,36029,7,1100532,1477879,377347
98000,89,36328,8,1205509,1392926,187417
98000,718,35958,7,1109105,1460537,351432
98000,179,36063,8,1114062,1500642,386580
98000,444,36147,8,1111902,1656401,544499
98000,61,36175,7,1169968,1347261,177293
98000,393,36253,8,1109395,1613729,504334
98000,399,36111,7,1141331,1468383,327052
98000,639,36137,7,1221739,1358544,136805
98000,565,36055,8,1090998,1354963,263965
98000,295,36016,7,1083513,1582696,499183
98000,228,36100,8,1105552,1296136,190584
98000,325,36023,9,1272954,1387959,115005
98000,828,35939,9,1093232,1551981,458749
98000,275,36094,7,1134629,1507739,373110
98000,421,36119,7,1114684,1492062,377378
98000,242,35991,8,1312741,1567881,255140
98000,147,36003,8,1087840,1424587,336747
98000,271,36067,8,1132785,1451630,318845
98000,453,36008,8,1209913,1416088,206175
98000,283,36226,8,1038777,1503783,465006
98000,177,36009,8,1222330,1429400,207070
98000,368,36174,8,1141737,1264260,122523
98000,576,36096,8,1136305,1411307,275002
98000,387,36056,7,1254677,1422059,167382
98000,233,36110,8,1221707,1576473,354766
98000,360,36005,8,1336335,1397739,61404
98000,238,36156,8,1183240,1502291,319051
99000,564,36334,7,1161818,1417724,255906
99000,640,36401,7,1134577,1400621,266044
99000,382,36498,8,1162682,1285460,122778
99000,191,36393,7,1127934,1404852,276918
99000,63,36353,8,1087572,1343649,256077
99000,188,36429,8,1081950,1284117,202167
99000,108,36433,8,1154621,1427637,273016
99000,469,36449,8,1057704,1421206,363502
99000,400,36564,8,1291970,1360599,68629
99000,401,36346,7,1112250,1317945,205695
99000,274,36363,9,1091160,1551143,459983
99000,447,36456,7,1225180,1463215,238035
99000,488,36404,8,1125977,1405571,279594
99000,245,36446,7,1324163,1420655,96492
99000,457,36273,7,1143851,1584069,440218
99000,358,36367,8,1249536,1456908,207372
99000,153,36403,7,1088151,1443964,355813
99000,240,36453,8,1345268,1507172,161904
99000,456,36302,8,1101097,1384862,283765
99000,309,36495,9,1173476,1468567,295091
99000,144,36586,9,1022649,1487534,464885
99000,510,36364,8,1511862,1562083,50221
99000,376,36305,9,1147533,1378269,230736
99000,183,36289,7,1273982,1445225,171243
99000,519,36352,8,1135856,1296084,160228
99000,378,36464,7,1231438,1450952,219514
99000,67,36646,8,1163896,1432853,268957
99000,326,36415,11,1171864,1421578,249714
99000,365,36505,8,1175348,1404169,228821
99000,594,36570,8,1044033,1313186,269153
99000,203,36459,8,1213246,1286828,73582
99000,218,36446,7,1215721,1461764,246043
99000,519,36434,8,1083925,1619719,535794
99000,162,36393,7,1087734,1402330,314596
99000,332,36327,7,1519807,1694565,174758
99000,527,36524,10,996680,1649369,652689
99000,242,36532,7,1172795,1480544,307749
99000,342,36430,8,1094406,1244191,149785
99000,654,36446,8,1866533,1927760,61227
99000,262,36522,8,1227833,1310134,82301
99000,630,36372,7,1168512,1420357,251845
99000,194,36449,7,1094456,1466704,372248
99000,281,36413,8,1171002,1852285,681283
99000,403,36556,9,1313923,1476311,162388
99000,186,36316,8,1175633,1410626,234993
99000,586,36492,7,1150687,1257704,107017
99000,414,36529,10,1246850,1422492,175642
99000,588,36455,7,1199839,1557366,357527
99000,436,36426,7,1203610,1417220,213610
99000,403,36373,8,1270352,1660361,390009
100000,625,36861,7,1447322,1543182,95860
100000,481,36865,7,1275026,1345016,69990
100000,244,36679,10,1344014,1351762,7748
100000,309,36851,7,1507660,1536001,28341
100000,461,36872,10,1193120,1402641,209521
100000,234,36883,8,1182701,1604872,422171
100000,683,36896,7,1137076,1308872,171796
100000,447,36671,7,1099104,1442391,343287
100000,280,37005,7,1083600,1679434,595834
100000,247,36785,8,1365068,1472580,107512
100000,173,36839,9,1120244,1297755,177511
100000,186,36789,8,961034,1574588,613554
100000,681,36798,8,1238295,1309798,71503
100000,174,36688,9,1182295,1343776,161481
100000,355,36674,8,1142473,1623282,480809
100000,177,36747,8,1391137,1525784,134647
100000,493,36841,8,1114612,1488617,374005
100000,530,36868,8,1120925,1547772,426847
100000,491,36782,8,1098174,1552351,454177
100000,215,36578,8,1159179,1528196,369017
100000,114,36835,7,1167467,1455690,288223
100000,252,36826,8,1061191,1353299,292108
100000,392,36948,8,1058998,1523395,464397
100000,110,36733,7,1366488,1617655,251167
100000,457,36869,7,1022574,1423432,400858
100000,419,36915,8,1202808,1374781,171973
100000,775,36576,8,1393348,1430631,37283
100000,355,36886,7,1113674,1501339,387665
100000,350,36724,8,1223117,1456339,233222
100000,466,36875,8,1086961,1278811,191850
100000,89,36850,8,1153883,1404892,251009
100000,438,36768,7,1248246,1419049,170803
100000,174,36642,8,1339658,1566612,226954
100000,130,36736,9,1493316,1530828,37512
100000,848,36808,8,1095923,1910835,814912
100000,831,36960,7,1083510,1492982,409472
100000,93,36826,8,1193390,1371320,177930
100000,369,36634,7,1141190,1435190,294000
100000,709,36928,8,1180486,1406751,226265
100000,788,36658,8,1174886,1674455,499569
100000,327,36689,8,1111182,1468979,357797
100000,490,36765,8,1151339,1454291,302952
100000,332,36969,8,1102243,1423843,321600
100000,488,36700,8,1204246,1426786,222540
100000,383,36726,7,1187564,1664908,477344
100000,180,36711,8,1416782,1433029,16247
100000,521,36654,8,1159664,1340320,180656
100000,216,36812,7,1256287,1397289,141002
100000,361,36931,7,1129124,1523828,394704
100000,442,36889,7,1062127,1562998,500871
